Address A,Port A,Address B,Port B,Packets,Bytes,Packets A -> B,Bytes A -> B,Packets B -> A,Bytes B -> A,Rel Start,Duration,Bits/s A -> B,Bits/s B -> A
10.11.1.31,60892,10.12.0.74,445,416,264930,180,17099,236,247831,479.924519,25.213583,5425.329673,78634.12352
10.11.1.31,60893,10.12.0.72,445,447,149971,214,26396,233,123575,479.929053,13.189887,16009.84148,74951.36236
10.11.1.31,60894,10.12.0.73,445,462,189861,213,25189,249,164672,479.937726,13.209826,15254.7051,99726.97596
10.11.1.31,60895,10.12.0.74,445,1,66,1,66,0,0,481.014597,0,0,0
10.11.1.31,60896,10.12.0.74,139,1,66,1,66,0,0,481.015527,0,0,0
10.11.1.79,2804,10.12.1.24,502,10,614,5,308,5,306,54.211439,0.042355,58174.94983,57797.19041
10.11.1.79,2805,10.12.1.24,502,10,613,5,308,5,305,54.235811,0.068309,36071.38152,35720.03689
10.11.1.79,2806,10.12.1.24,502,10,614,5,308,5,306,54.327464,0.039092,63030.79914,62621.50824
10.11.1.79,2807,10.12.1.24,502,10,613,5,308,5,305,54.35474,0.058421,42176.61457,41765.80339
10.11.1.79,2808,10.12.1.24,502,10,614,5,308,5,306,54.41895,0.047702,51654.0187,51318.60299
10.11.1.79,2809,10.12.1.24,502,10,614,5,308,5,306,59.227064,0.045256,54445.81934,54092.27506
10.11.1.79,2810,10.12.1.24,502,10,613,5,308,5,305,59.254572,0.087284,28229.687,27954.72252
10.11.1.79,2811,10.12.1.24,502,10,614,5,308,5,306,59.327044,0.10482,23506.96432,23354.32169
10.11.1.79,2812,10.12.1.24,502,10,613,5,308,5,305,59.414916,0.058451,42154.96741,41744.36708
10.11.1.79,2813,10.12.1.24,502,10,614,5,308,5,306,59.481677,0.050755,48546.94119,48231.70131
10.11.1.79,2872,10.12.1.24,502,10,614,5,308,5,306,144.21268,0.040891,60257.75843,59866.47429
10.11.1.79,2873,10.12.1.24,502,12,733,6,368,6,365,144.246271,3.003557,980.171177,972.1806511
10.11.1.79,2874,10.12.1.24,502,10,614,5,308,5,306,144.297672,0.034009,72451.40992,71980.94622
10.11.1.79,2875,10.12.1.24,502,10,613,5,308,5,305,144.323414,0.029819,82631.879,81827.02304
10.11.1.79,2876,10.12.1.24,502,10,614,5,308,5,306,144.357994,0.025802,95496.47314,94876.36617
10.11.1.79,2877,10.12.1.24,502,10,614,5,308,5,306,149.212791,0.031335,78634.11521,78123.50407
10.11.1.79,2878,10.12.1.24,502,10,613,5,308,5,305,149.238208,0.021877,112629.7024,111532.6599
10.11.1.79,2879,10.12.1.24,502,10,614,5,308,5,306,149.265858,0.026515,92928.53102,92325.099
10.11.1.79,2880,10.12.1.24,502,10,613,5,308,5,305,149.290236,0.018102,136117.5561,134791.7357
10.11.1.79,2881,10.12.1.24,502,10,614,5,308,5,306,149.326752,0.022372,110137.6721,109422.4924
10.11.1.79,2944,10.12.1.24,502,1,62,1,62,0,0,234.214005,0,0,0
10.11.1.79,2945,10.12.1.24,502,1,62,1,62,0,0,236.214651,0,0,0
10.11.1.79,2946,10.12.1.24,502,1,62,1,62,0,0,238.214673,0,0,0
10.11.1.79,2947,10.12.1.24,502,1,62,1,62,0,0,240.219993,0,0,0
10.11.1.79,2948,10.12.1.24,502,1,62,1,62,0,0,242.246624,0,0,0
10.11.1.79,2950,10.12.1.24,502,1,62,1,62,0,0,244.277941,0,0,0
10.11.1.79,3008,10.12.1.24,502,1,62,1,62,0,0,325.230989,0,0,0
10.11.1.79,3009,10.12.1.24,502,1,62,1,62,0,0,327.247269,0,0,0
10.11.1.79,3010,10.12.1.24,502,1,62,1,62,0,0,329.247351,0,0,0
10.11.1.79,3011,10.12.1.24,502,1,62,1,62,0,0,331.253739,0,0,0
10.11.1.79,3012,10.12.1.24,502,1,62,1,62,0,0,333.280881,0,0,0
10.11.1.79,3013,10.12.1.24,502,1,62,1,62,0,0,335.31054,0,0,0
10.11.1.79,3073,10.12.1.24,502,1,62,1,62,0,0,416.279315,0,0,0
10.11.1.79,3074,10.12.1.24,502,1,62,1,62,0,0,418.279904,0,0,0
10.11.1.79,3075,10.12.1.24,502,1,62,1,62,0,0,420.279986,0,0,0
10.11.1.79,3076,10.12.1.24,502,1,62,1,62,0,0,422.285133,0,0,0
10.11.1.79,3077,10.12.1.24,502,1,62,1,62,0,0,424.31189,0,0,0
10.11.1.79,3078,10.12.1.24,502,1,62,1,62,0,0,426.343078,0,0,0
10.11.1.79,3137,10.12.1.24,502,10,614,5,308,5,306,507.296204,0.232257,10608.93751,10540.04831
10.11.1.79,3138,10.12.1.24,502,10,613,5,308,5,305,507.484275,0.144757,17021.62935,16855.83426
10.11.1.79,3139,10.12.1.24,502,10,614,5,308,5,306,507.599103,0.229564,10733.39025,10663.69291
10.11.1.79,3140,10.12.1.24,502,10,613,5,308,5,305,507.750977,0.430786,5719.777337,5664.06522
10.11.1.79,3141,10.12.1.24,502,10,614,5,308,5,306,508.191535,0.085685,28756.4918,28569.76134
10.11.1.79,3142,10.12.1.24,502,10,614,5,308,5,306,512.31204,0.665562,3702.134437,3678.094603
10.11.1.79,3143,10.12.1.24,502,10,613,5,308,5,305,512.590419,0.49049,5023.547881,4974.61722
10.11.1.79,3144,10.12.1.24,502,10,614,5,308,5,306,513.067976,0.060668,40614.49199,40350.76152
10.11.1.79,3145,10.12.1.24,502,10,613,5,308,5,305,513.119653,0.578177,4261.670734,4220.160954
10.11.1.79,3146,10.12.1.24,502,10,614,5,308,5,306,513.660197,0.237821,10360.73349,10293.456
10.11.1.79,3206,10.12.1.24,502,10,614,5,308,5,306,597.297566,0.030098,81865.90471,81334.30793
10.11.1.79,3207,10.12.1.24,502,10,613,5,308,5,305,597.321638,0.028297,87076.36852,86228.22207
10.11.1.79,3208,10.12.1.24,502,10,614,5,308,5,306,597.350555,0.026516,92925.0264,92321.61714
10.11.1.79,3209,10.12.1.24,502,10,613,5,308,5,305,597.372374,0.018948,130040.1098,128773.4853
10.11.1.79,3210,10.12.1.24,502,10,614,5,308,5,306,597.411552,0.020784,118552.7329,117782.9099
10.11.1.79,3211,10.12.1.24,502,10,614,5,308,5,306,602.297792,0.023802,103520.7125,102848.5001
10.11.1.79,3212,10.12.1.24,502,10,613,5,308,5,305,602.318257,0.024219,101738.3046,100747.3471
10.11.1.79,3213,10.12.1.24,502,10,614,5,308,5,306,602.352376,0.031623,77917.9711,77412.01025
10.11.1.79,3214,10.12.1.24,502,10,613,5,308,5,305,602.381347,0.025005,98540.29194,97580.4839
10.11.1.79,3215,10.12.1.24,502,10,614,5,308,5,306,602.41388,0.026851,91765.66981,91169.78883
10.11.1.79,3274,10.12.1.24,502,10,614,5,308,5,306,687.298931,0.025007,98532.41093,97892.59007
10.11.1.79,3275,10.12.1.24,502,10,613,5,308,5,305,687.317984,0.019326,127496.6367,126254.7863
10.11.1.79,3276,10.12.1.24,502,10,614,5,308,5,306,687.351705,0.025272,97499.20861,96866.09687
10.11.1.79,3277,10.12.1.24,502,10,613,5,308,5,305,687.374697,0.017449,141211.5307,139836.0938
10.11.1.79,3278,10.12.1.24,502,10,614,5,308,5,306,687.412924,0.021235,116034.8481,115281.3751
10.11.1.79,3279,10.12.1.24,502,10,614,5,308,5,306,692.299046,0.022679,108646.7657,107941.2673
10.11.1.79,3280,10.12.1.24,502,10,613,5,308,5,305,692.31897,0.019081,129133.6932,127875.8975
10.11.1.79,3281,10.12.1.24,502,10,614,5,308,5,306,692.351813,0.019924,123669.9458,122866.8942
10.11.1.79,3282,10.12.1.24,502,10,613,5,308,5,305,692.369751,0.020273,121540.9658,120357.1252
10.11.1.79,3283,10.12.1.24,502,10,614,5,308,5,306,692.412913,0.021667,113721.3274,112982.8772
10.11.1.79,3344,10.12.1.24,502,10,614,5,308,5,306,777.300305,0.020729,118867.2874,118095.4219
10.11.1.79,3345,10.12.1.24,502,10,613,5,308,5,305,777.31823,0.017031,144677.3531,143268.1581
10.11.1.79,3346,10.12.1.24,502,10,614,5,308,5,306,777.353011,0.024921,98872.4369,98230.40809
10.11.1.79,3347,10.12.1.24,502,10,613,5,308,5,305,777.374232,0.019471,126547.1727,125314.5704
10.11.1.79,3348,10.12.1.24,502,10,614,5,308,5,306,777.414253,0.023454,105056.7067,104374.5203
10.11.1.79,3349,10.12.1.24,502,10,614,5,308,5,306,782.30058,0.026533,92865.48826,92262.46561
10.11.1.79,3350,10.12.1.24,502,10,613,5,308,5,305,782.325236,0.016474,149569.0178,148112.1768
10.11.1.79,3351,10.12.1.24,502,10,614,5,308,5,306,782.353283,0.025401,97004.05496,96374.1585
10.11.1.79,3352,10.12.1.24,502,10,613,5,308,5,305,782.376159,0.021526,114466.2269,113351.2961
10.11.1.79,3353,10.12.1.24,502,10,614,5,308,5,306,782.414288,0.020408,120736.9659,119952.9596
10.11.1.79,3412,10.12.1.24,502,10,614,5,308,5,306,867.317327,0.029704,82951.791,82413.14301
10.11.1.79,3413,10.12.1.24,502,10,613,5,308,5,305,867.340665,0.026422,93255.62032,92347.28635
10.11.1.79,3414,10.12.1.24,502,10,614,5,308,5,306,867.370233,0.027871,88407.30508,87833.23167
10.11.1.79,3415,10.12.1.24,502,10,613,5,308,5,305,867.391615,0.02212,111392.4051,110307.4141
10.11.1.79,3416,10.12.1.24,502,10,614,5,308,5,306,867.43116,0.023877,103195.5438,102525.4429
10.11.1.79,3417,10.12.1.24,502,10,614,5,308,5,306,872.317296,0.023575,104517.4973,103838.8123
10.11.1.79,3418,10.12.1.24,502,10,613,5,308,5,305,872.335438,0.025718,95808.38323,94875.1847
10.11.1.79,3419,10.12.1.24,502,10,614,5,308,5,306,872.370377,0.023418,105218.2082,104534.9731
10.11.1.79,3420,10.12.1.24,502,10,613,5,308,5,305,872.39147,0.01855,132830.1887,131536.3881
10.11.1.79,3421,10.12.1.24,502,10,614,5,308,5,306,872.431216,0.023356,105497.5167,104812.4679
10.11.1.80,3140,10.12.1.24,502,10,614,5,308,5,306,48.219576,0.034266,71908.01377,71441.07862
10.11.1.80,3141,10.12.1.24,502,10,613,5,308,5,305,48.245658,0.040007,61589.22189,60989.32687
10.11.1.80,3142,10.12.1.24,502,10,614,5,308,5,306,48.302933,0.038879,63376.11564,62964.58242
10.11.1.80,3143,10.12.1.24,502,10,613,5,308,5,305,48.328419,0.04498,54779.90218,54246.3317
10.11.1.80,3144,10.12.1.24,502,10,614,5,308,5,306,48.395479,0.03867,63718.64494,63304.88751
10.11.1.80,3146,10.12.1.24,502,10,614,5,308,5,306,53.235426,0.057022,43211.39209,42930.79864
10.11.1.80,3147,10.12.1.24,502,9,553,5,308,4,245,53.284296,0.04219,58402.46504,46456.50628
10.11.1.80,3148,10.12.1.24,502,10,614,5,308,5,306,53.334605,0.030251,81451.85283,80922.9447
10.11.1.80,3149,10.12.1.24,502,10,613,5,308,5,305,53.357256,0.037771,65235.23338,64599.82526
10.11.1.80,3150,10.12.1.24,502,10,614,5,308,5,306,53.395616,0.036624,67278.28746,66841.41547
10.11.1.80,3211,10.12.1.24,502,10,614,5,308,5,306,138.223626,0.0377,65358.09019,64933.687
10.11.1.80,3212,10.12.1.24,502,10,613,5,308,5,305,138.246775,0.043194,57044.95995,56489.32722
10.11.1.80,3213,10.12.1.24,502,10,614,5,308,5,306,138.307245,0.042013,58648.51356,58267.67905
10.11.1.80,3214,10.12.1.24,502,10,613,5,308,5,305,138.332578,0.05725,43039.30131,42620.08734
10.11.1.80,3215,10.12.1.24,502,10,614,5,308,5,306,138.399398,0.053055,46442.37112,46140.79729
10.11.1.80,3216,10.12.1.24,502,10,614,5,308,5,306,143.223775,0.090215,27312.53118,27135.17708
10.11.1.80,3217,10.12.1.24,502,10,613,5,308,5,305,143.27602,0.087348,28209.00307,27934.24005
10.11.1.80,3218,10.12.1.24,502,10,614,5,308,5,306,143.37004,0.080219,30715.91518,30516.46119
10.11.1.80,3219,10.12.1.24,502,10,613,5,308,5,305,143.414926,0.134978,18254.82671,18077.01996
10.11.1.80,3220,10.12.1.24,502,10,614,5,308,5,306,143.524822,0.158764,15519.89116,15419.11265
10.11.1.80,3282,10.12.1.24,502,1,62,1,62,0,0,228.227615,0,0,0
10.11.1.80,3302,10.12.1.24,502,1,62,1,62,0,0,230.228828,0,0,0
10.11.1.80,3311,10.12.1.24,502,1,62,1,62,0,0,232.228163,0,0,0
10.11.1.80,3312,10.12.1.24,502,1,62,1,62,0,0,234.232954,0,0,0
10.11.1.80,3313,10.12.1.24,502,1,62,1,62,0,0,236.260232,0,0,0
10.11.1.80,3321,10.12.1.24,502,1,62,1,62,0,0,238.400997,0,0,0
10.11.1.80,3383,10.12.1.24,502,1,62,1,62,0,0,319.247265,0,0,0
10.11.1.80,3384,10.12.1.24,502,1,62,1,62,0,0,321.263397,0,0,0
10.11.1.80,3385,10.12.1.24,502,1,62,1,62,0,0,323.263672,0,0,0
10.11.1.80,3386,10.12.1.24,502,1,62,1,62,0,0,325.268323,0,0,0
10.11.1.80,3387,10.12.1.24,502,1,62,1,62,0,0,327.295605,0,0,0
10.11.1.80,3388,10.12.1.24,502,1,62,1,62,0,0,329.326809,0,0,0
10.11.1.80,3448,10.12.1.24,502,1,62,1,62,0,0,410.282442,0,0,0
10.11.1.80,3449,10.12.1.24,502,1,62,1,62,0,0,412.298789,0,0,0
10.11.1.80,3450,10.12.1.24,502,1,62,1,62,0,0,414.298922,0,0,0
10.11.1.80,3451,10.12.1.24,502,1,62,1,62,0,0,416.303577,0,0,0
10.11.1.80,3452,10.12.1.24,502,1,62,1,62,0,0,418.330746,0,0,0
10.11.1.80,3453,10.12.1.24,502,1,62,1,62,0,0,420.362178,0,0,0
10.11.1.80,3513,10.12.1.24,502,10,614,5,308,5,306,501.317689,0.023474,104967.1978,104285.5926
10.11.1.80,3514,10.12.1.24,502,10,613,5,308,5,305,501.337972,0.020602,119600.0388,118435.1034
10.11.1.80,3515,10.12.1.24,502,10,614,5,308,5,306,501.370311,0.031724,77669.90291,77165.55289
10.11.1.80,3516,10.12.1.24,502,10,613,5,308,5,305,501.395304,0.025068,98292.64401,97335.24813
10.11.1.80,3517,10.12.1.24,502,10,614,5,308,5,306,501.431144,0.026034,94645.46362,94030.88269
10.11.1.80,3518,10.12.1.24,502,10,614,5,308,5,306,506.318007,0.062733,39277.57321,39022.52403
10.11.1.80,3519,10.12.1.24,502,10,613,5,308,5,305,506.363939,0.297722,8276.177105,8195.56499
10.11.1.80,3520,10.12.1.24,502,10,614,5,308,5,306,506.620327,0.218239,11290.37431,11217.0602
10.11.1.80,3521,10.12.1.24,502,10,613,5,308,5,305,506.76323,0.654207,3766.391983,3729.706347
10.11.1.80,3522,10.12.1.24,502,10,614,5,308,5,306,507.400038,0.189115,13029.10927,12944.50467
10.11.1.80,3581,10.12.1.24,502,10,614,5,308,5,306,591.321704,0.029215,84340.23618,83792.57231
10.11.1.80,3582,10.12.1.24,502,10,613,5,308,5,305,591.348133,0.023553,104615.1233,103596.1449
10.11.1.80,3583,10.12.1.24,502,10,614,5,308,5,306,591.405574,0.023403,105285.6471,104601.9741
10.11.1.80,3584,10.12.1.24,502,10,613,5,308,5,305,591.423286,0.023971,102790.8723,101789.6625
10.11.1.80,3585,10.12.1.24,502,10,614,5,308,5,306,591.466349,0.027042,91117.52089,90525.84868
10.11.1.80,3586,10.12.1.24,502,10,614,5,308,5,306,596.321895,0.029089,84705.5588,84155.52271
10.11.1.80,3587,10.12.1.24,502,10,613,5,308,5,305,596.344195,0.025325,97295.16288,96347.48272
10.11.1.80,3588,10.12.1.24,502,10,614,5,308,5,306,596.374245,0.033431,73704.04714,73225.44943
10.11.1.80,3589,10.12.1.24,502,10,613,5,308,5,305,596.403432,0.025806,95481.67093,94551.65465
10.11.1.80,3590,10.12.1.24,502,10,614,5,308,5,306,596.435323,0.032229,76452.88405,75956.43675
10.11.1.80,3652,10.12.1.24,502,10,614,5,308,5,306,681.325645,0.021202,116215.4514,115460.8056
10.11.1.80,3653,10.12.1.24,502,10,613,5,308,5,305,681.343997,0.015943,154550.5865,153045.2236
10.11.1.80,3654,10.12.1.24,502,10,614,5,308,5,306,681.378157,0.022995,107153.7291,106457.9256
10.11.1.80,3655,10.12.1.24,502,10,613,5,308,5,305,681.39876,0.017325,142222.2222,140836.9408
10.11.1.80,3656,10.12.1.24,502,10,614,5,308,5,306,681.439007,0.025149,97976.06267,97339.85447
10.11.1.80,3658,10.12.1.24,502,10,614,5,308,5,306,686.325905,0.023187,106266.4424,105576.4006
10.11.1.80,3659,10.12.1.24,502,10,613,5,308,5,305,686.346343,0.017432,141349.2428,139972.4644
10.11.1.80,3660,10.12.1.24,502,10,614,5,308,5,306,686.378269,0.021998,112010.1827,111282.8439
10.11.1.80,3661,10.12.1.24,502,10,613,5,308,5,305,686.397613,0.025659,96028.68389,95093.33957
10.11.1.80,3662,10.12.1.24,502,10,614,5,308,5,306,686.439264,0.023923,102997.1157,102328.3033
10.11.1.80,3721,10.12.1.24,502,10,614,5,308,5,306,771.329567,0.026294,93709.59154,93101.0877
10.11.1.80,3722,10.12.1.24,502,10,613,5,308,5,305,771.352365,0.016206,152042.4534,150561.5204
10.11.1.80,3723,10.12.1.24,502,10,614,5,308,5,306,771.382081,0.023012,107074.5698,106379.2804
10.11.1.80,3724,10.12.1.24,502,10,613,5,308,5,305,771.401895,0.018759,131350.2852,130070.8993
10.11.1.80,3725,10.12.1.24,502,10,614,5,308,5,306,771.443041,0.027626,89191.34149,88612.17693
10.11.1.80,3726,10.12.1.24,502,10,614,5,308,5,306,776.329863,0.02314,106482.2818,105790.8384
10.11.1.80,3727,10.12.1.24,502,10,613,5,308,5,305,776.35084,0.018975,129855.0725,128590.2503
10.11.1.80,3728,10.12.1.24,502,10,614,5,308,5,306,776.382173,0.026682,92346.90053,91747.24533
10.11.1.80,3729,10.12.1.24,502,10,613,5,308,5,305,776.406652,0.020369,120968.1379,119789.8768
10.11.1.80,3730,10.12.1.24,502,10,614,5,308,5,306,776.443169,0.023601,104402.3558,103724.4185
10.11.1.80,3795,10.12.1.24,502,10,614,5,308,5,306,861.333619,0.026722,92208.66702,91609.90944
10.11.1.80,3796,10.12.1.24,502,10,613,5,308,5,305,861.353577,0.027547,89447.12673,88575.88848
10.11.1.80,3797,10.12.1.24,502,10,614,5,308,5,306,861.38591,0.025742,95719.05835,95097.50602
10.11.1.80,3798,10.12.1.24,502,10,613,5,308,5,305,861.408349,0.022433,109838.1848,108768.3324
10.11.1.80,3799,10.12.1.24,502,10,614,5,308,5,306,861.447063,0.023159,106394.9221,105704.0459
10.11.1.80,3800,10.12.1.24,502,10,614,5,308,5,306,866.33395,0.034277,71884.93742,71418.15211
10.11.1.80,3801,10.12.1.24,502,10,613,5,308,5,305,866.359586,0.027867,88419.99498,87558.76126
10.11.1.80,3802,10.12.1.24,502,10,614,5,308,5,306,866.418163,0.0284,86760.56338,86197.1831
10.11.1.80,3803,10.12.1.24,502,10,613,5,308,5,305,866.442588,0.017889,137738.2749,136396.6683
10.11.1.80,3804,10.12.1.24,502,10,614,5,308,5,306,866.478477,0.027479,89668.47411,89086.21129
10.11.2.31,42523,10.12.17.19,502,2133,176642,1012,66300,1121,110342,0,894.581694,592.9028098,986.7583988
10.11.2.31,18128,10.12.17.20,502,3321,244695,1624,112314,1697,132381,0.004275,902.789157,995.2622858,1173.084537
10.11.2.31,56026,10.12.1.157,502,4604,397116,2014,128652,2590,268464,0.306285,901.123773,1142.147206,2383.370703
10.11.2.31,12639,10.12.1.80,502,64,7534,28,3545,36,3989,3.863279,199.77798,141.9575871,159.7373244
10.11.2.31,42522,10.12.1.240,502,302,22912,136,10567,166,12345,20.845488,881.473827,95.90301766,112.0396284
10.11.2.31,42491,10.12.1.33,502,909,66458,505,32724,404,33734,26.172824,875.631581,298.9750549,308.20268
10.11.2.31,15742,10.12.1.80,502,172,19734,76,9287,96,10447,220.859842,588.640684,126.2162165,141.9813517
10.11.2.31,19133,10.12.1.80,502,24,2732,12,1368,12,1364,840.434258,61.354556,178.3730617,177.851503
10.11.3.7,49291,10.12.0.241,445,54564,6465450,54564,6465450,0,0,0.498304,902.347887,57321.12941,0
10.11.9.178,58354,10.12.1.102,502,901,"147,885",451,74310,450,73575,0.093993,900.109481,660.4529922,653.9204535
10.11.9.178,58358,10.12.1.102,502,904,"148,482",452,74580,452,73902,0.886608,900.314912,662.7014526,656.676894
10.11.9.178,58352,10.12.1.102,502,904,"148,482",452,74580,452,73902,1.88571,900.329858,662.6904514,656.6659927
10.11.9.178,58353,10.12.1.102,502,900,"147,825",450,74250,450,73575,2.884673,896.325754,662.7054922,656.6808968
10.12.0.1,2552,10.11.9.28,502,1,62,1,62,0,0,0.57637,0,0,0
10.12.0.1,2558,10.11.9.28,502,1,62,1,62,0,0,0.693893,0,0,0
10.12.0.1,2559,10.11.9.28,502,2,124,2,124,0,0,0.760619,2.934587,338.0373456,0
10.12.0.1,2554,10.11.9.28,502,1,62,1,62,0,0,1.179927,0,0,0
10.12.0.1,2561,10.11.9.28,502,1,62,1,62,0,0,1.3194,0,0,0
10.12.0.1,2563,10.11.9.28,502,1,62,1,62,0,0,3.772481,0,0,0
10.12.0.1,2568,10.11.9.28,502,2,124,2,124,0,0,27.268816,2.984128,332.4254187,0
10.12.0.1,2569,10.11.9.28,502,2,124,2,124,0,0,29.738059,2.929247,338.6535857,0
10.12.0.1,2571,10.11.9.28,502,1,62,1,62,0,0,30.275922,0,0,0
10.12.0.1,2572,10.11.9.28,502,2,124,2,124,0,0,30.705946,2.967322,334.3081742,0
10.12.0.1,2574,10.11.9.28,502,2,124,2,124,0,0,31.323655,2.953283,335.8973725,0
10.12.0.1,2576,10.11.9.28,502,1,62,1,62,0,0,32.744913,0,0,0
10.12.0.1,2577,10.11.9.28,502,1,62,1,62,0,0,33.713766,0,0,0
10.12.0.1,2578,10.11.9.28,502,2,124,2,124,0,0,33.778479,3.013397,329.1965845,0
10.12.0.1,2580,10.11.9.28,502,1,62,1,62,0,0,34.3391,0,0,0
10.12.0.1,2582,10.11.9.28,502,1,62,1,62,0,0,36.792342,0,0,0
10.12.0.1,2589,10.11.9.28,502,2,124,2,124,0,0,60.286696,2.962607,334.8402269,0
10.12.0.1,2591,10.11.9.28,502,2,124,2,124,0,0,62.757629,3.006739,329.9255439,0
10.12.0.1,2592,10.11.9.28,502,1,62,1,62,0,0,63.295703,0,0,0
10.12.0.1,2593,10.11.9.28,502,2,124,2,124,0,0,63.72656,2.943194,337.048798,0
10.12.0.1,2595,10.11.9.28,502,2,124,2,124,0,0,64.35115,2.92228,339.4609688,0
10.12.0.1,2597,10.11.9.28,502,1,62,1,62,0,0,65.764852,0,0,0
10.12.0.1,2598,10.11.9.28,502,1,62,1,62,0,0,66.73369,0,0,0
10.12.0.1,2599,10.11.9.28,502,2,124,2,124,0,0,66.800415,2.887367,343.5656084,0
10.12.0.1,2601,10.11.9.28,502,1,62,1,62,0,0,67.359159,0,0,0
10.12.0.1,2603,10.11.9.28,502,1,62,1,62,0,0,69.812131,0,0,0
10.12.0.1,2608,10.11.9.28,502,1,62,1,62,0,0,93.30262,0,0,0
10.12.0.1,2609,10.11.9.28,502,2,124,2,124,0,0,95.778616,2.982222,332.6378787,0
10.12.0.1,2610,10.11.9.28,502,1,62,1,62,0,0,96.31559,0,0,0
10.12.0.1,2612,10.11.9.28,502,1,62,1,62,0,0,96.749155,0,0,0
10.12.0.1,2614,10.11.9.28,502,2,124,2,124,0,0,97.364459,3.005893,330.0184005,0
10.12.0.1,2616,10.11.9.28,502,1,62,1,62,0,0,98.784637,0,0,0
10.12.0.1,2617,10.11.9.28,502,1,62,1,62,0,0,99.753534,0,0,0
10.12.0.1,2618,10.11.9.28,502,2,124,2,124,0,0,99.819289,2.864822,346.2693319,0
10.12.0.1,2621,10.11.9.28,502,1,62,1,62,0,0,100.378921,0,0,0
10.12.0.1,2623,10.11.9.28,502,1,62,1,62,0,0,102.832124,0,0,0
10.12.0.1,2627,10.11.9.28,502,2,124,2,124,0,0,126.319657,2.922542,339.4305368,0
10.12.0.1,2629,10.11.9.28,502,2,124,2,124,0,0,128.790666,2.966504,334.4003581,0
10.12.0.1,2631,10.11.9.28,502,1,62,1,62,0,0,129.335401,0,0,0
10.12.0.1,2632,10.11.9.28,502,2,124,2,124,0,0,129.767323,2.99584,331.1258278,0
10.12.0.1,2635,10.11.9.28,502,2,124,2,124,0,0,130.39177,2.975007,333.4445936,0
10.12.0.1,2637,10.11.9.28,502,1,62,1,62,0,0,131.804559,0,0,0
10.12.0.1,2638,10.11.9.28,502,1,62,1,62,0,0,132.773514,0,0,0
10.12.0.1,2639,10.11.9.28,502,2,124,2,124,0,0,132.839106,2.942014,337.1839835,0
10.12.0.1,2641,10.11.9.28,502,1,62,1,62,0,0,133.39878,0,0,0
10.12.0.1,2643,10.11.9.28,502,1,62,1,62,0,0,135.851869,0,0,0
10.12.0.1,2648,10.11.9.28,502,2,124,2,124,0,0,159.344202,2.995085,331.2092979,0
10.12.0.1,2650,10.11.9.28,502,2,124,2,124,0,0,161.817279,2.936355,337.833811,0
10.12.0.1,2651,10.11.9.28,502,1,62,1,62,0,0,162.355271,0,0,0
10.12.0.1,2652,10.11.9.28,502,2,124,2,124,0,0,162.785207,2.974353,333.5179113,0
10.12.0.1,2654,10.11.9.28,502,2,124,2,124,0,0,163.412559,2.950599,336.2029202,0
10.12.0.1,2656,10.11.9.28,502,1,62,1,62,0,0,164.824523,0,0,0
10.12.0.1,2657,10.11.9.28,502,1,62,1,62,0,0,165.793234,0,0,0
10.12.0.1,2658,10.11.9.28,502,1,62,1,62,0,0,165.857861,0,0,0
10.12.0.1,2660,10.11.9.28,502,1,62,1,62,0,0,166.418661,0,0,0
10.12.0.1,2662,10.11.9.28,502,1,62,1,62,0,0,168.871843,0,0,0
10.12.0.1,2668,10.11.9.28,502,2,124,2,124,0,0,192.36417,2.971552,333.832287,0
10.12.0.1,2669,10.11.9.28,502,2,124,2,124,0,0,194.832209,2.918229,339.9321986,0
10.12.0.1,2670,10.11.9.28,502,1,62,1,62,0,0,195.375015,0,0,0
10.12.0.1,2671,10.11.9.28,502,1,62,1,62,0,0,195.805901,0,0,0
10.12.0.1,2673,10.11.9.28,502,1,62,1,62,0,0,196.43057,0,0,0
10.12.0.1,2675,10.11.9.28,502,1,62,1,62,0,0,197.844162,0,0,0
10.12.0.1,2676,10.11.9.28,502,1,62,1,62,0,0,198.813025,0,0,0
10.12.0.1,2677,10.11.9.28,502,2,124,2,124,0,0,198.877717,2.996811,331.0185394,0
10.12.0.1,2679,10.11.9.28,502,1,62,1,62,0,0,199.438432,0,0,0
10.12.0.1,2681,95.101.113.27,80,3,186,3,186,0,0,199.623381,8.890697,167.3659557,0
10.12.0.1,2683,10.11.9.28,502,1,62,1,62,0,0,201.891582,0,0,0
10.12.0.1,2687,95.101.113.32,80,3,186,3,186,0,0,220.586317,9.053609,164.3543475,0
10.12.0.1,2688,10.11.9.28,502,1,62,1,62,0,0,225.383056,0,0,0
10.12.0.1,2689,10.11.9.28,502,2,124,2,124,0,0,227.856838,2.990108,331.7605919,0
10.12.0.1,2690,10.11.9.28,502,1,62,1,62,0,0,228.394897,0,0,0
10.12.0.1,2691,10.11.9.28,502,2,124,2,124,0,0,228.824881,2.927469,338.8592672,0
10.12.0.1,2693,10.11.9.28,502,2,124,2,124,0,0,229.442528,3.014069,329.1231886,0
10.12.0.1,2696,10.11.9.28,502,1,62,1,62,0,0,230.864055,0,0,0
10.12.0.1,2697,10.11.9.28,502,1,62,1,62,0,0,231.832897,0,0,0
10.12.0.1,2698,10.11.9.28,502,2,124,2,124,0,0,231.898506,2.972514,333.7242482,0
10.12.0.1,2700,10.11.9.28,502,1,62,1,62,0,0,232.458259,0,0,0
10.12.0.1,2702,10.11.9.28,502,1,62,1,62,0,0,234.911274,0,0,0
10.12.0.1,2704,95.101.113.42,80,3,186,3,186,0,0,241.611368,9.05354,164.3556001,0
10.12.0.1,2707,10.11.9.28,502,2,124,2,124,0,0,258.40571,2.922672,339.415439,0
10.12.0.1,2709,10.11.9.28,502,2,124,2,124,0,0,260.873855,2.96945,334.0685986,0
10.12.0.1,2710,10.11.9.28,502,1,62,1,62,0,0,261.415021,0,0,0
10.12.0.1,2711,10.11.9.28,502,2,124,2,124,0,0,261.845743,3.003647,330.2651743,0
10.12.0.1,2713,10.11.9.28,502,2,124,2,124,0,0,262.46928,2.983711,332.4718781,0
10.12.0.1,2715,95.101.113.24,80,3,186,3,186,0,0,262.636692,9.053447,164.3572884,0
10.12.0.1,2716,10.11.9.28,502,1,62,1,62,0,0,263.88383,0,0,0
10.12.0.1,2717,10.11.9.28,502,1,62,1,62,0,0,264.852836,0,0,0
10.12.0.1,2718,10.11.9.28,502,1,62,1,62,0,0,264.919384,0,0,0
10.12.0.1,2720,10.11.9.28,502,1,62,1,62,0,0,265.478262,0,0,0
10.12.0.1,2722,10.11.9.28,502,1,62,1,62,0,0,267.931313,0,0,0
10.12.0.1,2726,95.101.113.41,80,3,186,3,186,0,0,283.661584,8.952981,166.201626,0
10.12.0.1,2729,10.11.9.28,502,2,124,2,124,0,0,291.421857,3.003588,330.2716618,0
10.12.0.1,2730,10.11.9.28,502,2,124,2,124,0,0,293.897512,2.942325,337.1483436,0
10.12.0.1,2731,10.11.9.28,502,1,62,1,62,0,0,294.434576,0,0,0
10.12.0.1,2732,10.11.9.28,502,1,62,1,62,0,0,294.864529,0,0,0
10.12.0.1,2734,10.11.9.28,502,2,124,2,124,0,0,295.491085,2.958302,335.3274953,0
10.12.0.1,2736,10.11.9.28,502,1,62,1,62,0,0,296.903753,0,0,0
10.12.0.1,2737,10.11.9.28,502,1,62,1,62,0,0,297.872749,0,0,0
10.12.0.1,2738,10.11.9.28,502,2,124,2,124,0,0,297.938266,2.925475,339.0902332,0
10.12.0.1,2740,10.11.9.28,502,1,62,1,62,0,0,298.497873,0,0,0
10.12.0.1,2743,10.11.9.28,502,1,62,1,62,0,0,300.951148,0,0,0
10.12.0.1,2744,95.101.113.34,80,3,186,3,186,0,0,304.686753,8.953121,166.1990271,0
10.12.0.1,2748,10.11.9.28,502,2,124,2,124,0,0,324.448306,2.973584,333.6041625,0
10.12.0.1,2749,95.101.113.33,80,3,186,3,186,0,0,325.611375,9.154053,162.5509487,0
10.12.0.1,2750,10.11.9.28,502,1,62,1,62,0,0,326.911498,0,0,0
10.12.0.1,2751,10.11.9.28,502,1,62,1,62,0,0,327.454366,0,0,0
10.12.0.1,2752,10.11.9.28,502,2,124,2,124,0,0,327.884394,2.957795,335.3849743,0
10.12.0.1,2754,10.11.9.28,502,1,62,1,62,0,0,328.50522,0,0,0
10.12.0.1,2757,10.11.9.28,502,1,62,1,62,0,0,329.923585,0,0,0
10.12.0.1,2758,10.11.9.28,502,1,62,1,62,0,0,330.892491,0,0,0
10.12.0.1,2759,10.11.9.28,502,2,124,2,124,0,0,330.956983,3.003779,330.2506609,0
10.12.0.1,2761,10.11.9.28,502,1,62,1,62,0,0,331.517834,0,0,0
10.12.0.1,2763,10.11.9.28,502,1,62,1,62,0,0,333.970997,0,0,0
10.12.0.1,2765,95.101.113.26,80,3,186,3,186,0,0,346.737336,9.053323,164.3595396,0
10.12.0.1,2768,10.11.9.28,502,2,124,2,124,0,0,357.464253,2.853425,347.6523827,0
10.12.0.1,2769,10.11.9.28,502,1,62,1,62,0,0,359.931325,0,0,0
10.12.0.1,2771,10.11.9.28,502,1,62,1,62,0,0,360.474302,0,0,0
10.12.0.1,2772,10.11.9.28,502,2,124,2,124,0,0,360.904253,2.934328,338.0671827,0
10.12.0.1,2774,10.11.9.28,502,2,124,2,124,0,0,361.523154,2.918971,339.8457881,0
10.12.0.1,2776,10.11.9.28,502,1,62,1,62,0,0,362.943362,0,0,0
10.12.0.1,2777,10.11.9.28,502,1,62,1,62,0,0,363.912383,0,0,0
10.12.0.1,2778,10.11.9.28,502,2,124,2,124,0,0,363.978821,2.978246,333.0819549,0
10.12.0.1,2780,10.11.9.28,502,1,62,1,62,0,0,364.537742,0,0,0
10.12.0.1,2782,10.11.9.28,502,1,62,1,62,0,0,366.990664,0,0,0
10.12.0.1,2783,95.101.113.40,80,3,186,3,186,0,0,367.762506,9.053265,164.3605926,0
10.12.0.1,2789,10.11.9.28,502,2,124,2,124,0,0,390.482095,2.932524,338.2751514,0
10.12.0.1,2790,10.11.9.28,502,2,124,2,124,0,0,392.950137,2.878793,344.5888607,0
10.12.0.1,2791,10.11.9.28,502,1,62,1,62,0,0,393.494218,0,0,0
10.12.0.1,2792,10.11.9.28,502,2,124,2,124,0,0,393.924054,2.910866,340.7920529,0
10.12.0.1,2794,10.11.9.28,502,2,124,2,124,0,0,394.549547,2.989629,331.8137468,0
10.12.0.1,2796,10.11.9.28,502,1,62,1,62,0,0,395.963108,0,0,0
10.12.0.1,2797,10.11.9.28,502,1,62,1,62,0,0,396.932088,0,0,0
10.12.0.1,2798,10.11.9.28,502,1,62,1,62,0,0,396.997697,0,0,0
10.12.0.1,2800,10.11.9.28,502,1,62,1,62,0,0,397.557515,0,0,0
10.12.0.1,2803,10.11.9.28,502,1,62,1,62,0,0,400.010525,0,0,0
10.12.0.1,2807,10.11.9.28,502,2,124,2,124,0,0,423.501038,3.010574,329.5052704,0
10.12.0.1,2808,10.11.9.28,502,2,124,2,124,0,0,425.970008,2.855257,347.4293207,0
10.12.0.1,2809,10.11.9.28,502,1,62,1,62,0,0,426.513953,0,0,0
10.12.0.1,2810,10.11.9.28,502,2,124,2,124,0,0,426.944827,2.886417,343.6786854,0
10.12.0.1,2812,10.11.9.28,502,2,124,2,124,0,0,427.568601,2.966946,334.3505409,0
10.12.0.1,2814,10.11.9.28,502,1,62,1,62,0,0,428.982989,0,0,0
10.12.0.1,2816,10.11.9.28,502,1,62,1,62,0,0,429.951802,0,0,0
10.12.0.1,2817,10.11.9.28,502,1,62,1,62,0,0,430.017836,0,0,0
10.12.0.1,2819,10.11.9.28,502,1,62,1,62,0,0,430.577271,0,0,0
10.12.0.1,2821,10.11.9.28,502,1,62,1,62,0,0,433.030522,0,0,0
10.12.0.1,2824,10.11.9.28,502,2,124,2,124,0,0,456.5249,2.98307,332.5433195,0
10.12.0.1,2826,10.11.9.28,502,2,124,2,124,0,0,458.994713,2.927622,338.8415581,0
10.12.0.1,2827,10.11.9.28,502,1,62,1,62,0,0,459.533825,0,0,0
10.12.0.1,2829,10.11.9.28,502,2,124,2,124,0,0,459.963733,2.964654,334.6090303,0
10.12.0.1,2831,10.11.9.28,502,2,124,2,124,0,0,460.587237,2.944645,336.8827142,0
10.12.0.1,2833,10.11.9.28,502,1,62,1,62,0,0,462.002893,0,0,0
10.12.0.1,2834,10.11.9.28,502,1,62,1,62,0,0,462.971609,0,0,0
10.12.0.1,2835,10.11.9.28,502,2,124,2,124,0,0,463.036452,3.01144,329.4105146,0
10.12.0.1,2837,10.11.9.28,502,1,62,1,62,0,0,463.597086,0,0,0
10.12.0.1,2839,10.11.9.28,502,1,62,1,62,0,0,466.050338,0,0,0
10.12.0.1,2843,10.11.9.28,502,2,124,2,124,0,0,489.545542,2.958902,335.2594983,0
10.12.0.1,2845,10.11.9.28,502,1,62,1,62,0,0,492.010818,0,0,0
10.12.0.1,2846,10.11.9.28,502,1,62,1,62,0,0,492.553942,0,0,0
10.12.0.1,2847,10.11.9.28,502,1,62,1,62,0,0,492.984668,0,0,0
10.12.0.1,2849,10.11.9.28,502,1,62,1,62,0,0,493.609333,0,0,0
10.12.0.1,2851,10.11.9.28,502,1,62,1,62,0,0,495.022717,0,0,0
10.12.0.1,2852,10.11.9.28,502,1,62,1,62,0,0,495.991421,0,0,0
10.12.0.1,2853,10.11.9.28,502,2,124,2,124,0,0,496.059193,2.883493,344.027192,0
10.12.0.1,2855,10.11.9.28,502,1,62,1,62,0,0,496.616961,0,0,0
10.12.0.1,2858,10.11.9.28,502,1,62,1,62,0,0,499.070113,0,0,0
10.12.0.1,2862,10.11.9.28,502,2,124,2,124,0,0,522.561438,2.93929,337.4964702,0
10.12.0.1,2863,10.11.9.28,502,2,124,2,124,0,0,525.032678,2.983019,332.5490049,0
10.12.0.1,2864,10.11.9.28,502,1,62,1,62,0,0,525.573445,0,0,0
10.12.0.1,2865,10.11.9.28,502,2,124,2,124,0,0,526.00348,2.917602,340.0052509,0
10.12.0.1,2867,10.11.9.28,502,2,124,2,124,0,0,526.627856,2.997518,330.9404647,0
10.12.0.1,2869,10.11.9.28,502,1,62,1,62,0,0,528.042472,0,0,0
10.12.0.1,2870,10.11.9.28,502,1,62,1,62,0,0,529.011327,0,0,0
10.12.0.1,2871,10.11.9.28,502,2,124,2,124,0,0,529.07636,2.86267,346.5296384,0
10.12.0.1,2873,10.11.9.28,502,1,62,1,62,0,0,529.636826,0,0,0
10.12.0.1,2876,10.11.9.28,502,1,62,1,62,0,0,532.089837,0,0,0
10.12.0.1,2880,10.11.9.28,502,1,62,1,62,0,0,555.586206,0,0,0
10.12.0.1,2881,10.11.9.28,502,2,124,2,124,0,0,558.052378,2.959763,335.1619707,0
10.12.0.1,2882,10.11.9.28,502,1,62,1,62,0,0,558.593244,0,0,0
10.12.0.1,2883,10.11.9.28,502,1,62,1,62,0,0,559.023073,0,0,0
10.12.0.1,2885,10.11.9.28,502,2,124,2,124,0,0,559.64882,2.972883,333.6828257,0
10.12.0.1,2888,10.11.9.28,502,1,62,1,62,0,0,561.06241,0,0,0
10.12.0.1,2889,10.11.9.28,502,1,62,1,62,0,0,562.031439,0,0,0
10.12.0.1,2890,10.11.9.28,502,2,124,2,124,0,0,562.09994,2.936227,337.8485383,0
10.12.0.1,2892,10.11.9.28,502,1,62,1,62,0,0,562.656551,0,0,0
10.12.0.1,2894,10.11.9.28,502,1,62,1,62,0,0,565.10967,0,0,0
10.12.0.1,2899,10.11.9.28,502,2,124,2,124,0,0,588.599303,2.994845,331.2358403,0
10.12.0.1,2901,10.11.9.28,502,2,124,2,124,0,0,591.073109,2.935421,337.9413038,0
10.12.0.1,2902,10.11.9.28,502,1,62,1,62,0,0,591.613024,0,0,0
10.12.0.1,2903,10.11.9.28,502,2,124,2,124,0,0,592.043072,2.971491,333.83914,0
10.12.0.1,2905,10.11.9.28,502,2,124,2,124,0,0,592.667026,2.951015,336.1555261,0
10.12.0.1,2907,10.11.9.28,502,1,62,1,62,0,0,594.082324,0,0,0
10.12.0.1,2908,10.11.9.28,502,1,62,1,62,0,0,595.05125,0,0,0
10.12.0.1,2909,10.11.9.28,502,1,62,1,62,0,0,595.116725,0,0,0
10.12.0.1,2911,10.11.9.28,502,1,62,1,62,0,0,595.676455,0,0,0
10.12.0.1,2913,10.11.9.28,502,1,62,1,62,0,0,598.129675,0,0,0
10.12.0.1,2917,10.11.9.28,502,2,124,2,124,0,0,621.620123,2.970444,333.9568092,0
10.12.0.1,2918,10.11.9.28,502,1,62,1,62,0,0,624.091168,0,0,0
10.12.0.1,2919,10.11.9.28,502,1,62,1,62,0,0,624.632889,0,0,0
10.12.0.1,2920,10.11.9.28,502,2,124,2,124,0,0,625.055038,2.955826,335.6083883,0
10.12.0.1,2922,10.11.9.28,502,2,124,2,124,0,0,625.682545,2.93192,338.3448389,0
10.12.0.1,2925,10.11.9.28,502,1,62,1,62,0,0,627.101916,0,0,0
10.12.0.1,2926,10.11.9.28,502,1,62,1,62,0,0,628.070928,0,0,0
10.12.0.1,2927,10.11.9.28,502,2,124,2,124,0,0,628.136535,2.992958,331.4446778,0
10.12.0.1,2929,10.11.9.28,502,1,62,1,62,0,0,628.69619,0,0,0
10.12.0.1,2932,10.11.9.28,502,1,62,1,62,0,0,631.149722,0,0,0
10.12.0.1,2935,10.11.9.28,502,2,124,2,124,0,0,654.636963,2.95003,336.2677668,0
10.12.0.1,2936,10.11.9.28,502,2,124,2,124,0,0,657.11074,2.99113,331.647237,0
10.12.0.1,2937,10.11.9.28,502,1,62,1,62,0,0,657.652689,0,0,0
10.12.0.1,2938,10.11.9.28,502,2,124,2,124,0,0,658.082642,2.924581,339.1938879,0
10.12.0.1,2940,10.11.9.28,502,2,124,2,124,0,0,658.710109,3.001324,330.5207968,0
10.12.0.1,2943,10.11.9.28,502,1,62,1,62,0,0,660.121861,0,0,0
10.12.0.1,2944,10.11.9.28,502,1,62,1,62,0,0,661.090917,0,0,0
10.12.0.1,2945,10.11.9.28,502,2,124,2,124,0,0,661.156304,2.969531,334.0594862,0
10.12.0.1,2947,10.11.9.28,502,1,62,1,62,0,0,661.71603,0,0,0
10.12.0.1,2949,10.11.9.28,502,1,62,1,62,0,0,664.169169,0,0,0
10.12.0.1,2954,10.11.9.28,502,2,124,2,124,0,0,687.656801,2.926413,338.981545,0
10.12.0.1,2956,10.11.9.28,502,2,124,2,124,0,0,690.129612,2.968671,334.1562605,0
10.12.0.1,2957,10.11.9.28,502,1,62,1,62,0,0,690.672528,0,0,0
10.12.0.1,2958,10.11.9.28,502,1,62,1,62,0,0,691.103085,0,0,0
10.12.0.1,2960,10.11.9.28,502,2,124,2,124,0,0,691.729036,2.979855,332.9021043,0
10.12.0.1,2962,10.11.9.28,502,1,62,1,62,0,0,693.141567,0,0,0
10.12.0.1,2963,10.11.9.28,502,1,62,1,62,0,0,694.110484,0,0,0
10.12.0.1,2964,10.11.9.28,502,2,124,2,124,0,0,694.175221,2.946973,336.6165893,0
10.12.0.1,2966,10.11.9.28,502,1,62,1,62,0,0,694.735952,0,0,0
10.12.0.1,2968,10.11.9.28,502,1,62,1,62,0,0,697.189016,0,0,0
10.12.0.1,2972,10.11.9.28,502,2,124,2,124,0,0,720.676635,3.003594,330.271002,0
10.12.0.1,2973,10.11.9.28,502,1,62,1,62,0,0,723.15568,0,0,0
10.12.0.1,2974,10.11.9.28,502,1,62,1,62,0,0,723.692311,0,0,0
10.12.0.1,2975,10.11.9.28,502,2,124,2,124,0,0,724.122381,2.978255,333.0809484,0
10.12.0.1,2977,10.11.9.28,502,2,124,2,124,0,0,724.747787,2.956443,335.5383479,0
10.12.0.1,2979,10.11.9.28,502,1,62,1,62,0,0,726.161454,0,0,0
10.12.0.1,2981,10.11.9.28,502,1,62,1,62,0,0,727.130522,0,0,0
10.12.0.1,2982,10.11.9.28,502,2,124,2,124,0,0,727.196006,2.922559,339.4285624,0
10.12.0.1,2984,10.11.9.28,502,1,62,1,62,0,0,727.755814,0,0,0
10.12.0.1,2987,10.11.9.28,502,1,62,1,62,0,0,730.208824,0,0,0
10.12.0.1,2990,10.11.9.28,502,2,124,2,124,0,0,753.701203,2.874927,345.0522396,0
10.12.0.1,2991,10.11.9.28,502,1,62,1,62,0,0,756.171243,0,0,0
10.12.0.1,2992,10.11.9.28,502,1,62,1,62,0,0,756.712136,0,0,0
10.12.0.1,2993,10.11.9.28,502,2,124,2,124,0,0,757.142106,2.954854,335.7187868,0
10.12.0.1,2995,10.11.9.28,502,1,62,1,62,0,0,757.769656,0,0,0
10.12.0.1,2998,10.11.9.28,502,1,62,1,62,0,0,759.181284,0,0,0
10.12.0.1,3000,10.11.9.28,502,1,62,1,62,0,0,760.15013,0,0,0
10.12.0.1,3001,10.11.9.28,502,2,124,2,124,0,0,760.215909,2.9997,330.6997366,0
10.12.0.1,3003,10.11.9.28,502,1,62,1,62,0,0,760.775674,0,0,0
10.12.0.1,3005,10.11.9.28,502,1,62,1,62,0,0,763.228794,0,0,0
10.12.0.1,3008,10.11.9.28,502,2,124,2,124,0,0,786.716183,2.85638,347.2927272,0
10.12.0.1,3010,10.11.9.28,502,1,62,1,62,0,0,789.193038,0,0,0
10.12.0.1,3011,10.11.9.28,502,1,62,1,62,0,0,789.732005,0,0,0
10.12.0.1,3013,10.11.9.28,502,2,124,2,124,0,0,790.163869,2.929538,338.6199462,0
10.12.0.1,3015,10.11.9.28,502,1,62,1,62,0,0,790.789661,0,0,0
10.12.0.1,3017,10.11.9.28,502,1,62,1,62,0,0,792.201065,0,0,0
10.12.0.1,3018,10.11.9.28,502,1,62,1,62,0,0,793.169995,0,0,0
10.12.0.1,3019,10.11.9.28,502,2,124,2,124,0,0,793.238508,2.973505,333.6130257,0
10.12.0.1,3021,10.11.9.28,502,1,62,1,62,0,0,793.795454,0,0,0
10.12.0.1,3023,10.11.9.28,502,1,62,1,62,0,0,796.248547,0,0,0
10.12.0.1,3027,10.11.9.28,502,1,62,1,62,0,0,819.743936,0,0,0
10.12.0.1,3029,10.11.9.28,502,2,124,2,124,0,0,822.214992,2.86888,345.7795377,0
10.12.0.1,3030,10.11.9.28,502,1,62,1,62,0,0,822.751971,0,0,0
10.12.0.1,3031,10.11.9.28,502,2,124,2,124,0,0,823.181815,2.907985,341.1296826,0
10.12.0.1,3033,10.11.9.28,502,2,124,2,124,0,0,823.806307,2.987662,332.0322044,0
10.12.0.1,3035,10.11.9.28,502,1,62,1,62,0,0,825.22102,0,0,0
10.12.0.1,3036,10.11.9.28,502,1,62,1,62,0,0,826.190208,0,0,0
10.12.0.1,3037,10.11.9.28,502,1,62,1,62,0,0,826.256437,0,0,0
10.12.0.1,3039,10.11.9.28,502,1,62,1,62,0,0,826.815279,0,0,0
10.12.0.1,3042,10.11.9.28,502,1,62,1,62,0,0,829.268362,0,0,0
10.12.0.1,3047,10.11.9.28,502,2,124,2,124,0,0,852.760719,3.005675,330.0423366,0
10.12.0.1,3048,10.11.9.28,502,2,124,2,124,0,0,855.227913,2.852308,347.7885277,0
10.12.0.1,3049,10.11.9.28,502,1,62,1,62,0,0,855.771605,0,0,0
10.12.0.1,3050,10.11.9.28,502,2,124,2,124,0,0,856.20281,2.883398,344.0385268,0
10.12.0.1,3052,10.11.9.28,502,2,124,2,124,0,0,856.828468,2.861304,346.6950733,0
10.12.0.1,3055,10.11.9.28,502,1,62,1,62,0,0,858.240936,0,0,0
10.12.0.1,3056,10.11.9.28,502,1,62,1,62,0,0,859.209651,0,0,0
10.12.0.1,3057,10.11.9.28,502,1,62,1,62,0,0,859.276348,0,0,0
10.12.0.1,3059,10.11.9.28,502,1,62,1,62,0,0,859.835036,0,0,0
10.12.0.1,3062,10.11.9.28,502,1,62,1,62,0,0,862.288115,0,0,0
10.12.0.1,3065,10.11.9.28,502,2,124,2,124,0,0,885.778551,2.984247,332.4121629,0
10.12.0.1,3067,10.11.9.28,502,2,124,2,124,0,0,888.253652,2.923484,339.3211661,0
10.12.0.1,3068,10.11.9.28,502,1,62,1,62,0,0,888.791526,0,0,0
10.12.0.1,3069,10.11.9.28,502,2,124,2,124,0,0,889.216542,2.866031,346.1232624,0
10.12.0.1,3071,10.11.9.28,502,2,124,2,124,0,0,889.844275,2.942402,337.1395207,0
10.12.0.1,3074,10.11.9.28,502,1,62,1,62,0,0,891.260605,0,0,0
10.12.0.1,3075,10.11.9.28,502,1,62,1,62,0,0,892.22943,0,0,0
10.12.0.1,3076,10.11.9.28,502,2,124,2,124,0,0,892.29512,3.006522,329.9493568,0
10.12.0.1,3078,10.11.9.28,502,1,62,1,62,0,0,892.854846,0,0,0
10.12.0.1,3080,10.11.9.28,502,1,62,1,62,0,0,895.308017,0,0,0
10.12.0.2,2489,10.11.9.28,502,2,124,2,124,0,0,0.374283,2.918164,339.9397703,0
10.12.0.2,2486,10.11.9.28,502,1,62,1,62,0,0,1.481831,0,0,0
10.12.0.2,2490,10.11.9.28,502,1,62,1,62,0,0,1.566383,0,0,0
10.12.0.2,2491,10.11.9.28,502,2,124,2,124,0,0,1.936928,2.964891,334.5822831,0
10.12.0.2,2487,10.11.9.28,502,1,62,1,62,0,0,2.688907,0,0,0
10.12.0.2,2492,10.11.9.28,502,1,62,1,62,0,0,2.726129,0,0,0
10.12.0.2,2488,10.11.9.28,502,1,62,1,62,0,0,2.789504,0,0,0
10.12.0.2,2493,10.11.9.28,502,1,62,1,62,0,0,2.86329,0,0,0
10.12.0.2,2494,10.11.9.28,502,1,62,1,62,0,0,3.378913,0,0,0
10.12.0.2,2495,10.11.9.28,502,1,62,1,62,0,0,4.941471,0,0,0
10.12.0.2,2503,10.11.9.28,502,2,124,2,124,0,0,31.572572,3.002346,330.4082874,0
10.12.0.2,2504,10.11.9.28,502,2,124,2,124,0,0,32.738097,2.943243,337.0431867,0
10.12.0.2,2505,10.11.9.28,502,1,62,1,62,0,0,32.872978,0,0,0
10.12.0.2,2506,10.11.9.28,502,2,124,2,124,0,0,33.387598,2.997814,330.9077881,0
10.12.0.2,2507,10.11.9.28,502,1,62,1,62,0,0,34.58234,0,0,0
10.12.0.2,2508,10.11.9.28,502,1,62,1,62,0,0,34.944389,0,0,0
10.12.0.2,2509,10.11.9.28,502,1,62,1,62,0,0,35.738533,0,0,0
10.12.0.2,2510,10.11.9.28,502,1,62,1,62,0,0,35.879116,0,0,0
10.12.0.2,2511,10.11.9.28,502,1,62,1,62,0,0,36.394771,0,0,0
10.12.0.2,2512,10.11.9.28,502,1,62,1,62,0,0,37.957348,0,0,0
10.12.0.2,2518,10.11.9.28,502,2,124,2,124,0,0,64.587325,2.980023,332.8833368,0
10.12.0.2,2519,10.11.9.28,502,2,124,2,124,0,0,65.740176,2.93352,338.1602989,0
10.12.0.2,2520,10.11.9.28,502,2,124,2,124,0,0,65.883738,2.991164,331.6434672,0
10.12.0.2,2521,10.11.9.28,502,2,124,2,124,0,0,66.401632,2.976208,333.3100375,0
10.12.0.2,2522,10.11.9.28,502,1,62,1,62,0,0,67.59787,0,0,0
10.12.0.2,2523,10.11.9.28,502,1,62,1,62,0,0,67.970194,0,0,0
10.12.0.2,2525,10.11.9.28,502,1,62,1,62,0,0,68.754236,0,0,0
10.12.0.2,2526,10.11.9.28,502,1,62,1,62,0,0,68.894803,0,0,0
10.12.0.2,2527,10.11.9.28,502,1,62,1,62,0,0,69.410449,0,0,0
10.12.0.2,2528,10.11.9.28,502,1,62,1,62,0,0,70.97292,0,0,0
10.12.0.2,2533,10.11.9.28,502,2,124,2,124,0,0,97.603854,2.955851,335.6055498,0
10.12.0.2,2535,10.11.9.28,502,2,124,2,124,0,0,98.75593,3.010746,329.4864462,0
10.12.0.2,2536,10.11.9.28,502,2,124,2,124,0,0,98.897545,2.969805,334.0286652,0
10.12.0.2,2537,10.11.9.28,502,2,124,2,124,0,0,99.417214,2.953033,335.9258092,0
10.12.0.2,2538,10.11.9.28,502,1,62,1,62,0,0,100.613756,0,0,0
10.12.0.2,2539,10.11.9.28,502,2,124,2,124,0,0,100.97504,3.004588,330.1617393,0
10.12.0.2,2540,10.11.9.28,502,1,62,1,62,0,0,101.769973,0,0,0
10.12.0.2,2541,10.11.9.28,502,1,62,1,62,0,0,101.910599,0,0,0
10.12.0.2,2542,10.11.9.28,502,1,62,1,62,0,0,102.426278,0,0,0
10.12.0.2,2543,10.11.9.28,502,1,62,1,62,0,0,103.988902,0,0,0
10.12.0.2,2550,10.11.9.28,502,2,124,2,124,0,0,130.61956,2.932477,338.280573,0
10.12.0.2,2551,10.11.9.28,502,2,124,2,124,0,0,131.776866,2.982212,332.6389941,0
10.12.0.2,2552,10.11.9.28,502,2,124,2,124,0,0,131.918405,2.941229,337.2739763,0
10.12.0.2,2553,10.11.9.28,502,2,124,2,124,0,0,132.438187,2.924482,339.2053704,0
10.12.0.2,2554,10.11.9.28,502,1,62,1,62,0,0,133.629839,0,0,0
10.12.0.2,2555,10.11.9.28,502,2,124,2,124,0,0,133.999377,2.972675,333.7061737,0
10.12.0.2,2556,10.11.9.28,502,1,62,1,62,0,0,134.785948,0,0,0
10.12.0.2,2557,10.11.9.28,502,1,62,1,62,0,0,134.926556,0,0,0
10.12.0.2,2558,10.11.9.28,502,1,62,1,62,0,0,135.442067,0,0,0
10.12.0.2,2559,10.11.9.28,502,1,62,1,62,0,0,137.004613,0,0,0
10.12.0.2,2565,10.11.9.28,502,2,124,2,124,0,0,163.634049,3.011056,329.4525243,0
10.12.0.2,2566,10.11.9.28,502,2,124,2,124,0,0,164.787927,2.963676,334.7194498,0
10.12.0.2,2567,10.11.9.28,502,2,124,2,124,0,0,164.931171,2.920983,339.6116992,0
10.12.0.2,2568,10.11.9.28,502,2,124,2,124,0,0,165.450736,3.004864,330.1314136,0
10.12.0.2,2569,10.11.9.28,502,1,62,1,62,0,0,166.645535,0,0,0
10.12.0.2,2570,10.11.9.28,502,2,124,2,124,0,0,167.015322,2.949146,336.3685623,0
10.12.0.2,2571,10.11.9.28,502,1,62,1,62,0,0,167.801697,0,0,0
10.12.0.2,2572,10.11.9.28,502,1,62,1,62,0,0,167.942432,0,0,0
10.12.0.2,2573,10.11.9.28,502,1,62,1,62,0,0,168.457937,0,0,0
10.12.0.2,2574,10.11.9.28,502,1,62,1,62,0,0,170.020601,0,0,0
10.12.0.2,2580,10.11.9.28,502,2,124,2,124,0,0,196.653321,2.883522,344.0237321,0
10.12.0.2,2581,10.11.9.28,502,2,124,2,124,0,0,197.809395,2.934617,338.0338899,0
10.12.0.2,2582,10.11.9.28,502,2,124,2,124,0,0,197.950992,2.994118,331.3162674,0
10.12.0.2,2583,10.11.9.28,502,2,124,2,124,0,0,198.459854,2.988237,331.9683144,0
10.12.0.2,2584,10.11.9.28,502,1,62,1,62,0,0,199.661388,0,0,0
10.12.0.2,2585,10.11.9.28,502,2,124,2,124,0,0,200.031424,2.92544,339.0942901,0
10.12.0.2,2586,10.11.9.28,502,1,62,1,62,0,0,200.817657,0,0,0
10.12.0.2,2587,10.11.9.28,502,1,62,1,62,0,0,200.958626,0,0,0
10.12.0.2,2588,10.11.9.28,502,1,62,1,62,0,0,201.47396,0,0,0
10.12.0.2,2589,10.11.9.28,502,1,62,1,62,0,0,203.036401,0,0,0
10.12.0.2,2595,10.11.9.28,502,2,124,2,124,0,0,229.672136,2.957871,335.3763568,0
10.12.0.2,2596,10.11.9.28,502,2,124,2,124,0,0,230.819951,2.916402,340.1451515,0
10.12.0.2,2597,10.11.9.28,502,2,124,2,124,0,0,230.962076,2.874868,345.059321,0
10.12.0.2,2598,10.11.9.28,502,2,124,2,124,0,0,231.481092,2.959376,335.2058001,0
10.12.0.2,2599,10.11.9.28,502,1,62,1,62,0,0,232.678983,0,0,0
10.12.0.2,2600,10.11.9.28,502,2,124,2,124,0,0,233.041066,3.008903,329.6882618,0
10.12.0.2,2601,10.11.9.28,502,1,62,1,62,0,0,233.833425,0,0,0
10.12.0.2,2602,10.11.9.28,502,1,62,1,62,0,0,233.974096,0,0,0
10.12.0.2,2603,10.11.9.28,502,1,62,1,62,0,0,234.489654,0,0,0
10.12.0.2,2604,10.11.9.28,502,1,62,1,62,0,0,236.052289,0,0,0
10.12.0.2,2610,10.11.9.28,502,2,124,2,124,0,0,262.682209,2.940152,337.3975223,0
10.12.0.2,2611,10.11.9.28,502,2,124,2,124,0,0,263.844311,2.985088,332.3185112,0
10.12.0.2,2612,10.11.9.28,502,2,124,2,124,0,0,263.985899,2.843496,348.8663251,0
10.12.0.2,2613,10.11.9.28,502,2,124,2,124,0,0,264.493903,2.838383,349.4947652,0
10.12.0.2,2614,10.11.9.28,502,1,62,1,62,0,0,265.693025,0,0,0
10.12.0.2,2615,10.11.9.28,502,2,124,2,124,0,0,266.061884,2.980476,332.8327422,0
10.12.0.2,2616,10.11.9.28,502,1,62,1,62,0,0,266.849351,0,0,0
10.12.0.2,2617,10.11.9.28,502,1,62,1,62,0,0,266.990174,0,0,0
10.12.0.2,2618,10.11.9.28,502,1,62,1,62,0,0,267.505597,0,0,0
10.12.0.2,2619,10.11.9.28,502,1,62,1,62,0,0,269.068091,0,0,0
10.12.0.2,2625,10.11.9.28,502,2,124,2,124,0,0,295.696019,2.918836,339.8615064,0
10.12.0.2,2626,10.11.9.28,502,2,124,2,124,0,0,296.853063,2.868071,345.8770721,0
10.12.0.2,2627,10.11.9.28,502,2,124,2,124,0,0,296.995095,2.826677,350.9421133,0
10.12.0.2,2628,10.11.9.28,502,2,124,2,124,0,0,297.516319,2.909029,341.0072571,0
10.12.0.2,2629,10.11.9.28,502,1,62,1,62,0,0,298.708859,0,0,0
10.12.0.2,2630,10.11.9.28,502,2,124,2,124,0,0,299.070483,2.863706,346.4042747,0
10.12.0.2,2631,10.11.9.28,502,1,62,1,62,0,0,299.865232,0,0,0
10.12.0.2,2632,10.11.9.28,502,1,62,1,62,0,0,300.005844,0,0,0
10.12.0.2,2633,10.11.9.28,502,1,62,1,62,0,0,300.521426,0,0,0
10.12.0.2,2634,10.11.9.28,502,1,62,1,62,0,0,302.083909,0,0,0
10.12.0.2,2640,10.11.9.28,502,1,62,1,62,0,0,328.717897,0,0,0
10.12.0.2,2641,10.11.9.28,502,1,62,1,62,0,0,329.870154,0,0,0
10.12.0.2,2642,10.11.9.28,502,2,124,2,124,0,0,330.011796,3.003578,330.2727614,0
10.12.0.2,2643,10.11.9.28,502,2,124,2,124,0,0,330.531446,2.986905,332.1163546,0
10.12.0.2,2644,10.11.9.28,502,1,62,1,62,0,0,331.724711,0,0,0
10.12.0.2,2645,10.11.9.28,502,2,124,2,124,0,0,332.08573,2.840843,349.1921236,0
10.12.0.2,2646,10.11.9.28,502,1,62,1,62,0,0,332.881055,0,0,0
10.12.0.2,2647,10.11.9.28,502,1,62,1,62,0,0,333.021678,0,0,0
10.12.0.2,2648,10.11.9.28,502,1,62,1,62,0,0,333.537405,0,0,0
10.12.0.2,2649,10.11.9.28,502,1,62,1,62,0,0,335.09983,0,0,0
10.12.0.2,2655,10.11.9.28,502,2,124,2,124,0,0,361.728637,2.971572,333.8300401,0
10.12.0.2,2656,10.11.9.28,502,2,124,2,124,0,0,362.8833,2.923376,339.3337019,0
10.12.0.2,2657,10.11.9.28,502,2,124,2,124,0,0,363.026663,2.981177,332.7544792,0
10.12.0.2,2658,10.11.9.28,502,2,124,2,124,0,0,363.546015,2.964755,334.5976312,0
10.12.0.2,2659,10.11.9.28,502,1,62,1,62,0,0,364.740581,0,0,0
10.12.0.2,2660,10.11.9.28,502,1,62,1,62,0,0,365.110406,0,0,0
10.12.0.2,2661,10.11.9.28,502,1,62,1,62,0,0,365.896946,0,0,0
10.12.0.2,2662,10.11.9.28,502,1,62,1,62,0,0,366.037516,0,0,0
10.12.0.2,2663,10.11.9.28,502,1,62,1,62,0,0,366.553269,0,0,0
10.12.0.2,2664,10.11.9.28,502,1,62,1,62,0,0,368.115624,0,0,0
10.12.0.2,2670,10.11.9.28,502,2,124,2,124,0,0,394.749257,2.943298,337.0368886,0
10.12.0.2,2671,10.11.9.28,502,2,124,2,124,0,0,395.903509,2.996236,331.0820643,0
10.12.0.2,2672,10.11.9.28,502,1,62,1,62,0,0,396.046157,0,0,0
10.12.0.2,2673,10.11.9.28,502,1,62,1,62,0,0,396.555149,0,0,0
10.12.0.2,2674,10.11.9.28,502,1,62,1,62,0,0,397.756462,0,0,0
10.12.0.2,2675,10.11.9.28,502,2,124,2,124,0,0,398.123497,2.988977,331.8861269,0
10.12.0.2,2677,10.11.9.28,502,1,62,1,62,0,0,398.912645,0,0,0
10.12.0.2,2678,10.11.9.28,502,1,62,1,62,0,0,399.053385,0,0,0
10.12.0.2,2679,10.11.9.28,502,1,62,1,62,0,0,399.568965,0,0,0
10.12.0.2,2680,10.11.9.28,502,1,62,1,62,0,0,401.131514,0,0,0
10.12.0.2,2685,10.11.9.28,502,2,124,2,124,0,0,427.762257,2.922738,339.4077745,0
10.12.0.2,2687,10.11.9.28,502,2,124,2,124,0,0,428.915696,2.976278,333.3021982,0
10.12.0.2,2688,10.11.9.28,502,1,62,1,62,0,0,429.057175,0,0,0
10.12.0.2,2689,10.11.9.28,502,1,62,1,62,0,0,429.575005,0,0,0
10.12.0.2,2690,10.11.9.28,502,1,62,1,62,0,0,430.772433,0,0,0
10.12.0.2,2691,10.11.9.28,502,2,124,2,124,0,0,431.143101,2.961757,334.9363233,0
10.12.0.2,2692,10.11.9.28,502,1,62,1,62,0,0,431.92856,0,0,0
10.12.0.2,2693,10.11.9.28,502,1,62,1,62,0,0,432.069236,0,0,0
10.12.0.2,2694,10.11.9.28,502,1,62,1,62,0,0,432.585009,0,0,0
10.12.0.2,2695,10.11.9.28,502,1,62,1,62,0,0,434.147497,0,0,0
10.12.0.2,2701,10.11.9.28,502,2,124,2,124,0,0,460.780074,2.997928,330.895205,0
10.12.0.2,2702,10.11.9.28,502,1,62,1,62,0,0,461.933686,0,0,0
10.12.0.2,2703,10.11.9.28,502,1,62,1,62,0,0,462.074869,0,0,0
10.12.0.2,2704,10.11.9.28,502,2,124,2,124,0,0,462.594527,2.994176,331.3098495,0
10.12.0.2,2705,10.11.9.28,502,1,62,1,62,0,0,463.788319,0,0,0
10.12.0.2,2706,10.11.9.28,502,2,124,2,124,0,0,464.157081,2.94015,337.3977518,0
10.12.0.2,2707,10.11.9.28,502,1,62,1,62,0,0,464.944331,0,0,0
10.12.0.2,2708,10.11.9.28,502,1,62,1,62,0,0,465.085104,0,0,0
10.12.0.2,2709,10.11.9.28,502,1,62,1,62,0,0,465.600769,0,0,0
10.12.0.2,2710,10.11.9.28,502,1,62,1,62,0,0,467.163115,0,0,0
10.12.0.2,2716,10.11.9.28,502,2,124,2,124,0,0,493.795993,2.97436,333.5171264,0
10.12.0.2,2717,10.11.9.28,502,2,124,2,124,0,0,494.95139,2.925362,339.1033315,0
10.12.0.2,2718,10.11.9.28,502,2,124,2,124,0,0,495.094548,2.983378,332.5089881,0
10.12.0.2,2719,10.11.9.28,502,2,124,2,124,0,0,495.603998,2.980779,332.7989093,0
10.12.0.2,2720,10.11.9.28,502,1,62,1,62,0,0,496.803926,0,0,0
10.12.0.2,2721,10.11.9.28,502,1,62,1,62,0,0,497.173848,0,0,0
10.12.0.2,2722,10.11.9.28,502,1,62,1,62,0,0,497.960355,0,0,0
10.12.0.2,2723,10.11.9.28,502,1,62,1,62,0,0,498.100787,0,0,0
10.12.0.2,2724,10.11.9.28,502,1,62,1,62,0,0,498.616379,0,0,0
10.12.0.2,2725,10.11.9.28,502,1,62,1,62,0,0,500.178882,0,0,0
10.12.0.2,2731,10.11.9.28,502,2,124,2,124,0,0,526.813791,2.948921,336.3942269,0
10.12.0.2,2732,10.11.9.28,502,2,124,2,124,0,0,527.965306,3.004353,330.1875645,0
10.12.0.2,2733,10.11.9.28,502,1,62,1,62,0,0,528.106645,0,0,0
10.12.0.2,2734,10.11.9.28,502,1,62,1,62,0,0,528.626239,0,0,0
10.12.0.2,2735,10.11.9.28,502,1,62,1,62,0,0,529.819695,0,0,0
10.12.0.2,2736,10.11.9.28,502,2,124,2,124,0,0,530.187697,2.994908,331.2288725,0
10.12.0.2,2737,10.11.9.28,502,1,62,1,62,0,0,530.976057,0,0,0
10.12.0.2,2738,10.11.9.28,502,1,62,1,62,0,0,531.116601,0,0,0
10.12.0.2,2739,10.11.9.28,502,1,62,1,62,0,0,531.632313,0,0,0
10.12.0.2,2740,10.11.9.28,502,1,62,1,62,0,0,533.195535,0,0,0
10.12.0.2,2746,10.11.9.28,502,2,124,2,124,0,0,559.821528,2.933493,338.1634113,0
10.12.0.2,2747,10.11.9.28,502,2,124,2,124,0,0,560.98674,2.975292,333.4126533,0
10.12.0.2,2748,10.11.9.28,502,1,62,1,62,0,0,561.119375,0,0,0
10.12.0.2,2749,10.11.9.28,502,2,124,2,124,0,0,561.640167,2.92549,339.0884946,0
10.12.0.2,2750,10.11.9.28,502,1,62,1,62,0,0,562.835544,0,0,0
10.12.0.2,2751,10.11.9.28,502,1,62,1,62,0,0,563.205364,0,0,0
10.12.0.2,2752,10.11.9.28,502,1,62,1,62,0,0,563.991806,0,0,0
10.12.0.2,2753,10.11.9.28,502,1,62,1,62,0,0,564.132428,0,0,0
10.12.0.2,2754,10.11.9.28,502,1,62,1,62,0,0,564.648076,0,0,0
10.12.0.2,2755,10.11.9.28,502,1,62,1,62,0,0,566.21059,0,0,0
10.12.0.2,2761,10.11.9.28,502,2,124,2,124,0,0,592.83752,3.010426,329.5214697,0
10.12.0.2,2762,10.11.9.28,502,2,124,2,124,0,0,594.002395,2.952141,336.0273103,0
10.12.0.2,2763,10.11.9.28,502,1,62,1,62,0,0,594.14491,0,0,0
10.12.0.2,2764,10.11.9.28,502,1,62,1,62,0,0,594.653926,0,0,0
10.12.0.2,2765,10.11.9.28,502,1,62,1,62,0,0,595.851348,0,0,0
10.12.0.2,2766,10.11.9.28,502,1,62,1,62,0,0,596.221141,0,0,0
10.12.0.2,2767,10.11.9.28,502,1,62,1,62,0,0,597.007758,0,0,0
10.12.0.2,2768,10.11.9.28,502,1,62,1,62,0,0,597.148261,0,0,0
10.12.0.2,2769,10.11.9.28,502,1,62,1,62,0,0,597.664044,0,0,0
10.12.0.2,2770,10.11.9.28,502,1,62,1,62,0,0,599.226362,0,0,0
10.12.0.2,2776,10.11.9.28,502,2,124,2,124,0,0,625.85408,2.885765,343.756335,0
10.12.0.2,2777,10.11.9.28,502,2,124,2,124,0,0,627.012323,2.934528,338.044142,0
10.12.0.2,2778,10.11.9.28,502,2,124,2,124,0,0,627.153813,2.994168,331.3107347,0
10.12.0.2,2779,10.11.9.28,502,2,124,2,124,0,0,627.674444,2.976551,333.2716288,0
10.12.0.2,2780,10.11.9.28,502,1,62,1,62,0,0,628.867257,0,0,0
10.12.0.2,2781,10.11.9.28,502,2,124,2,124,0,0,629.237373,2.922306,339.4579486,0
10.12.0.2,2782,10.11.9.28,502,1,62,1,62,0,0,630.023388,0,0,0
10.12.0.2,2783,10.11.9.28,502,1,62,1,62,0,0,630.163999,0,0,0
10.12.0.2,2784,10.11.9.28,502,1,62,1,62,0,0,630.679798,0,0,0
10.12.0.2,2785,10.11.9.28,502,1,62,1,62,0,0,632.242201,0,0,0
10.12.0.2,2791,10.11.9.28,502,2,124,2,124,0,0,658.873152,2.858958,346.9795639,0
10.12.0.2,2792,10.11.9.28,502,2,124,2,124,0,0,660.035001,2.904097,341.5863864,0
10.12.0.2,2793,10.11.9.28,502,2,124,2,124,0,0,660.166795,2.872962,345.2882426,0
10.12.0.2,2794,10.11.9.28,502,2,124,2,124,0,0,660.685785,2.957599,335.4072002,0
10.12.0.2,2795,10.11.9.28,502,1,62,1,62,0,0,661.882885,0,0,0
10.12.0.2,2796,10.11.9.28,502,1,62,1,62,0,0,662.249722,0,0,0
10.12.0.2,2797,10.11.9.28,502,1,62,1,62,0,0,663.039218,0,0,0
10.12.0.2,2798,10.11.9.28,502,1,62,1,62,0,0,663.180056,0,0,0
10.12.0.2,2799,10.11.9.28,502,1,62,1,62,0,0,663.695541,0,0,0
10.12.0.2,2800,10.11.9.28,502,1,62,1,62,0,0,665.258071,0,0,0
10.12.0.2,2806,10.11.9.28,502,2,124,2,124,0,0,691.892721,2.831689,350.3209569,0
10.12.0.2,2807,10.11.9.28,502,2,124,2,124,0,0,693.047999,2.883477,344.029101,0
10.12.0.2,2808,10.11.9.28,502,2,124,2,124,0,0,693.189575,2.84258,348.9787447,0
10.12.0.2,2809,10.11.9.28,502,2,124,2,124,0,0,693.699192,2.835838,349.8084164,0
10.12.0.2,2810,10.11.9.28,502,1,62,1,62,0,0,694.898672,0,0,0
10.12.0.2,2811,10.11.9.28,502,2,124,2,124,0,0,695.265506,2.979481,332.9438919,0
10.12.0.2,2812,10.11.9.28,502,1,62,1,62,0,0,696.054994,0,0,0
10.12.0.2,2813,10.11.9.28,502,1,62,1,62,0,0,696.195571,0,0,0
10.12.0.2,2814,10.11.9.28,502,1,62,1,62,0,0,696.711311,0,0,0
10.12.0.2,2815,10.11.9.28,502,1,62,1,62,0,0,698.273712,0,0,0
10.12.0.2,2821,10.11.9.28,502,1,62,1,62,0,0,724.90678,0,0,0
10.12.0.2,2822,10.11.9.28,502,2,124,2,124,0,0,726.062939,2.961488,334.9667464,0
10.12.0.2,2823,10.11.9.28,502,2,124,2,124,0,0,726.204293,2.820134,351.756335,0
10.12.0.2,2824,10.11.9.28,502,2,124,2,124,0,0,726.714387,2.91352,340.4816167,0
10.12.0.2,2825,10.11.9.28,502,1,62,1,62,0,0,727.914423,0,0,0
10.12.0.2,2826,10.11.9.28,502,2,124,2,124,0,0,728.282238,2.854499,347.5215791,0
10.12.0.2,2828,10.11.9.28,502,1,62,1,62,0,0,729.070717,0,0,0
10.12.0.2,2829,10.11.9.28,502,1,62,1,62,0,0,729.211378,0,0,0
10.12.0.2,2830,10.11.9.28,502,1,62,1,62,0,0,729.726959,0,0,0
10.12.0.2,2831,10.11.9.28,502,1,62,1,62,0,0,731.289493,0,0,0
10.12.0.2,2836,10.11.9.28,502,2,124,2,124,0,0,757.925476,2.984837,332.3464564,0
10.12.0.2,2838,10.11.9.28,502,2,124,2,124,0,0,759.079652,2.937209,337.735585,0
10.12.0.2,2839,10.11.9.28,502,2,124,2,124,0,0,759.221032,2.996885,331.0103658,0
10.12.0.2,2840,10.11.9.28,502,2,124,2,124,0,0,759.729155,2.991692,331.5849359,0
10.12.0.2,2841,10.11.9.28,502,1,62,1,62,0,0,760.930228,0,0,0
10.12.0.2,2842,10.11.9.28,502,2,124,2,124,0,0,761.298434,2.830701,350.4432294,0
10.12.0.2,2843,10.11.9.28,502,1,62,1,62,0,0,762.086615,0,0,0
10.12.0.2,2844,10.11.9.28,502,1,62,1,62,0,0,762.227155,0,0,0
10.12.0.2,2845,10.11.9.28,502,1,62,1,62,0,0,762.742843,0,0,0
10.12.0.2,2846,10.11.9.28,502,1,62,1,62,0,0,764.30534,0,0,0
10.12.0.2,2852,10.11.9.28,502,2,124,2,124,0,0,790.93274,2.969879,334.0203422,0
10.12.0.2,2853,10.11.9.28,502,2,124,2,124,0,0,792.089513,2.919545,339.7789724,0
10.12.0.2,2854,10.11.9.28,502,2,124,2,124,0,0,792.230951,2.979308,332.963225,0
10.12.0.2,2855,10.11.9.28,502,2,124,2,124,0,0,792.751761,2.961416,334.9748904,0
10.12.0.2,2856,10.11.9.28,502,1,62,1,62,0,0,793.945968,0,0,0
10.12.0.2,2857,10.11.9.28,502,1,62,1,62,0,0,794.31291,0,0,0
10.12.0.2,2858,10.11.9.28,502,1,62,1,62,0,0,795.102266,0,0,0
10.12.0.2,2859,10.11.9.28,502,1,62,1,62,0,0,795.242822,0,0,0
10.12.0.2,2860,10.11.9.28,502,1,62,1,62,0,0,795.75854,0,0,0
10.12.0.2,2861,10.11.9.28,502,1,62,1,62,0,0,797.321046,0,0,0
10.12.0.2,2867,10.11.9.28,502,2,124,2,124,0,0,823.953867,2.941169,337.2808567,0
10.12.0.2,2868,10.11.9.28,502,2,124,2,124,0,0,825.107236,2.994726,331.2490024,0
10.12.0.2,2869,10.11.9.28,502,2,124,2,124,0,0,825.248539,2.95403,335.8124325,0
10.12.0.2,2870,10.11.9.28,502,2,124,2,124,0,0,825.769775,2.935783,337.8996336,0
10.12.0.2,2871,10.11.9.28,502,1,62,1,62,0,0,826.961968,0,0,0
10.12.0.2,2872,10.11.9.28,502,2,124,2,124,0,0,827.329833,2.985045,332.3232983,0
10.12.0.2,2873,10.11.9.28,502,1,62,1,62,0,0,828.118239,0,0,0
10.12.0.2,2874,10.11.9.28,502,1,62,1,62,0,0,828.258581,0,0,0
10.12.0.2,2875,10.11.9.28,502,1,62,1,62,0,0,828.774605,0,0,0
10.12.0.2,2876,10.11.9.28,502,1,62,1,62,0,0,830.336788,0,0,0
10.12.0.2,2882,10.11.9.28,502,2,124,2,124,0,0,856.96669,2.920572,339.6594914,0
10.12.0.2,2883,10.11.9.28,502,2,124,2,124,0,0,858.120258,2.974109,333.5452736,0
10.12.0.2,2884,10.11.9.28,502,2,124,2,124,0,0,858.261823,2.933107,338.207914,0
10.12.0.2,2885,10.11.9.28,502,1,62,1,62,0,0,858.781329,0,0,0
10.12.0.2,2886,10.11.9.28,502,1,62,1,62,0,0,859.977608,0,0,0
10.12.0.2,2887,10.11.9.28,502,2,124,2,124,0,0,860.345377,2.961828,334.9282943,0
10.12.0.2,2888,10.11.9.28,502,1,62,1,62,0,0,861.133845,0,0,0
10.12.0.2,2889,10.11.9.28,502,1,62,1,62,0,0,861.274505,0,0,0
10.12.0.2,2890,10.11.9.28,502,1,62,1,62,0,0,861.790065,0,0,0
10.12.0.2,2891,10.11.9.28,502,1,62,1,62,0,0,863.352551,0,0,0
10.12.0.2,2897,10.11.9.28,502,2,124,2,124,0,0,889.981299,2.998852,330.7932502,0
10.12.0.2,2898,10.11.9.28,502,1,62,1,62,0,0,891.137276,0,0,0
10.12.0.2,2899,10.11.9.28,502,2,124,2,124,0,0,891.27852,3.009376,329.6364429,0
10.12.0.2,2900,10.11.9.28,502,2,124,2,124,0,0,891.796903,2.993846,331.3463685,0
10.12.0.2,2901,10.11.9.28,502,1,62,1,62,0,0,892.993262,0,0,0
10.12.0.2,2902,10.11.9.28,502,2,124,2,124,0,0,893.361081,2.938457,337.5921444,0
10.12.0.2,2903,10.11.9.28,502,1,62,1,62,0,0,894.149486,0,0,0
10.12.0.2,2904,10.11.9.28,502,1,62,1,62,0,0,894.290812,0,0,0
10.12.0.2,2905,10.11.9.28,502,1,62,1,62,0,0,894.805786,0,0,0
10.12.0.2,2906,10.11.9.28,502,1,62,1,62,0,0,896.368451,0,0,0
10.12.0.7,2396,10.238.200.37,80,3,186,3,186,0,0,172.245368,9.118667,163.1817458,0
10.12.0.7,2397,10.238.200.37,80,3,186,3,186,0,0,193.51004,9.073489,163.9942474,0
10.12.0.7,2398,10.238.200.37,80,3,186,3,186,0,0,216.889642,8.882248,167.525158,0
10.12.0.22,52082,23.0.40.234,80,3,194,3,194,0,0,90.231457,9.004038,172.3671091,0
10.12.0.22,52105,23.0.40.234,80,3,194,3,194,0,0,411.243877,8.999859,172.4471461,0
10.12.0.22,52113,23.0.40.234,80,3,194,3,194,0,0,732.263303,9.009733,172.2581568,0
10.12.0.41,4085,10.238.200.37,80,3,186,3,186,0,0,695.363215,8.990046,165.5163945,0
10.12.0.41,4085,10.238.200.37,80,3,186,3,186,0,0,716.324863,8.950892,166.2404149,0
10.12.0.42,4480,10.11.9.208,502,9,559,6,368,3,191,149.187718,60.04646,49.02870211,25.44696224
10.12.0.42,4481,10.11.9.208,502,9,593,6,368,3,225,149.187986,60.155629,48.93972599,29.92238681
10.12.0.42,4482,10.11.9.208,502,10,623,6,368,4,255,149.188284,60.233306,48.87661321,33.86830535
10.12.0.42,4483,10.11.9.208,502,10,627,6,368,4,259,149.188653,60.326801,48.80086382,34.34626013
10.12.0.42,4484,10.11.9.208,502,9,559,6,368,3,191,150.133858,60.07494,49.00545885,25.43489848
10.12.0.42,4485,10.11.9.208,502,9,593,6,368,3,225,150.134102,60.168384,48.92935134,29.91604362
10.12.0.42,4486,10.11.9.208,502,10,623,6,368,4,255,150.134353,60.261907,48.85341581,33.85223106
10.12.0.42,4487,10.11.9.208,502,10,627,6,368,4,259,150.134675,60.339692,48.79043798,34.33892238
10.12.0.42,4488,10.11.9.208,502,17,"1,136",9,566,8,570,150.13496,61.112029,74.09343257,74.61706107
10.12.0.42,4489,10.11.9.208,502,7,424,5,304,2,120,150.135233,62.877316,38.67849576,15.26782727
10.12.0.42,4490,10.11.9.208,502,10,613,6,368,4,245,150.167246,60.45858,48.69449464,32.4188891
10.12.0.42,4491,10.11.9.208,502,10,645,6,368,4,277,150.167452,60.552074,48.61930906,36.59659948
10.12.0.42,4492,10.11.9.208,502,10,635,6,368,4,267,150.167821,60.645436,48.54446095,35.22111705
10.12.0.42,4493,10.11.9.208,502,10,619,6,368,4,251,150.168085,60.723344,48.48217845,33.06800759
10.12.0.42,4494,10.11.9.208,502,9,559,6,368,3,191,231.263678,60.057257,49.0198878,25.44238742
10.12.0.42,4495,10.11.9.208,502,9,593,6,368,3,225,231.263861,60.166314,48.93103473,29.91707287
10.12.0.42,4496,10.11.9.208,502,10,623,6,368,4,255,231.264224,60.25965,48.85524559,33.85349898
10.12.0.42,4497,10.11.9.208,502,10,627,6,368,4,259,231.264541,60.337533,48.7921838,34.3401511
10.12.0.42,4498,10.11.9.208,502,9,559,6,368,3,191,234.2948,60.125782,48.96402013,25.41339088
10.12.0.42,4499,10.11.9.208,502,10,653,6,368,4,285,234.295062,60.235305,48.87499117,37.85155566
10.12.0.42,4500,10.11.9.208,502,10,623,6,368,4,255,234.295328,60.312716,48.81226042,33.82371306
10.12.0.42,4501,10.11.9.208,502,10,627,6,368,4,259,234.295599,60.406205,48.73671504,34.30111195
10.12.0.42,4502,10.11.9.208,502,16,"1,076",9,566,7,510,234.295849,61.02514,74.19892851,66.85769176
10.12.0.42,4503,10.11.9.208,502,9,544,6,364,3,180,234.296082,63.024936,46.20393427,22.84809936
10.12.0.42,4504,10.11.9.208,502,9,544,6,364,3,180,234.296309,63.024758,46.20406476,22.84816389
10.12.0.42,4505,10.11.9.208,502,9,544,6,364,3,180,234.296542,63.024637,46.20415346,22.84820776
10.12.0.42,4506,10.11.9.208,502,9,559,6,368,3,191,449.197668,60.041577,49.03268946,25.44903176
10.12.0.42,4507,10.11.9.208,502,9,593,6,368,3,225,449.197958,60.150763,48.94368505,29.92480744
10.12.0.42,4508,10.11.9.208,502,10,623,6,368,4,255,449.198161,60.244207,48.86776915,33.86217699
10.12.0.42,4509,10.11.9.208,502,10,627,6,368,4,259,449.198428,60.337561,48.79216115,34.34013516
10.12.0.42,4510,10.11.9.208,502,9,559,6,368,3,191,450.143813,60.087573,48.99515579,25.42955097
10.12.0.42,4511,10.11.9.208,502,9,593,6,368,3,225,450.144034,60.181091,48.9190201,29.90972696
10.12.0.42,4512,10.11.9.208,502,10,623,6,368,4,255,450.144267,60.290144,48.83053522,33.83637631
10.12.0.42,4513,10.11.9.208,502,10,627,6,368,4,259,450.144602,60.367989,48.76756786,34.32282629
10.12.0.42,4514,10.11.9.208,502,17,"1,136",9,566,8,570,450.144901,61.06897,74.14567496,74.66967267
10.12.0.42,4515,10.11.9.208,502,9,544,6,364,3,180,450.145174,63.037453,46.1947598,22.84356254
10.12.0.42,4516,10.11.9.208,502,10,613,6,368,4,245,450.177324,60.50136,48.66006318,32.39596597
10.12.0.42,4517,10.11.9.208,502,10,645,6,368,4,277,450.177607,60.594921,48.58493008,36.57072183
10.12.0.42,4518,10.11.9.208,502,10,635,6,368,4,267,450.177978,60.688201,48.51025325,35.19629788
10.12.0.42,4519,10.11.9.208,502,10,619,6,368,4,251,450.178262,60.76607,48.44808953,33.04475672
10.12.0.42,4520,10.11.9.208,502,9,559,6,368,3,191,531.273522,60.03382,49.039025,25.45232004
10.12.0.42,4521,10.11.9.208,502,9,593,6,368,3,225,531.273578,60.143078,48.94993901,29.92863119
10.12.0.42,4522,10.11.9.208,502,10,623,6,368,4,255,531.2738,60.220958,48.88663511,33.87524988
10.12.0.42,4523,10.11.9.208,502,10,627,6,368,4,259,531.274134,60.314387,48.81090808,34.35332933
10.12.0.42,4524,10.11.9.208,502,9,559,6,368,3,191,534.304738,60.068061,49.01107096,25.43781129
10.12.0.42,4525,10.11.9.208,502,9,593,6,368,3,225,534.304992,60.161657,48.93482239,29.91938869
10.12.0.42,4526,10.11.9.208,502,10,623,6,368,4,255,534.305299,60.239338,48.87171901,33.86491399
10.12.0.42,4527,10.11.9.208,502,10,627,6,368,4,259,534.305587,60.332779,48.79602844,34.34285697
10.12.0.42,4528,10.11.9.208,502,16,"1,076",9,566,7,510,534.305973,60.771903,74.50811603,67.13628829
10.12.0.42,4529,10.11.9.208,502,7,424,5,304,2,120,534.306229,62.959259,38.62815476,15.24795582
10.12.0.42,4530,10.11.9.208,502,7,424,5,304,2,120,534.306499,62.958992,38.62831857,15.24802049
10.12.0.42,4531,10.11.9.208,502,9,544,6,364,3,180,534.306773,62.974248,46.24112383,22.86648981
10.12.0.42,4533,10.11.9.208,502,9,559,6,368,3,191,749.20378,60.059945,49.01769391,25.44124874
10.12.0.42,4534,10.11.9.208,502,9,593,6,368,3,225,749.204066,60.168907,48.92892603,29.91578358
10.12.0.42,4535,10.11.9.208,502,10,623,6,368,4,255,749.204372,60.246722,48.86572916,33.86076341
10.12.0.42,4536,10.11.9.208,502,10,627,6,368,4,259,749.204584,60.324705,48.80255942,34.3474535
10.12.0.42,4537,10.11.9.208,502,9,559,6,368,3,191,750.160506,60.069023,49.01028605,25.4374039
10.12.0.42,4538,10.11.9.208,502,9,593,6,368,3,225,750.160771,60.162415,48.93420585,29.91901173
10.12.0.42,4539,10.11.9.208,502,10,623,6,368,4,255,750.161098,60.255832,48.85834121,33.85564405
10.12.0.42,4540,10.11.9.208,502,10,627,6,368,4,259,750.161284,60.33387,48.79514608,34.34223596
10.12.0.42,4541,10.11.9.208,502,17,"1,136",9,566,8,570,750.161611,61.192984,73.99541098,74.51834674
10.12.0.42,4542,10.11.9.208,502,9,544,6,364,3,180,750.161865,62.880158,46.3103162,22.90070582
10.12.0.42,4543,10.11.9.208,502,10,613,6,368,4,245,750.193595,60.467576,48.68725017,32.41406601
10.12.0.42,4544,10.11.9.208,502,10,645,6,368,4,277,750.193831,60.561071,48.61208614,36.59116266
10.12.0.42,4545,10.11.9.208,502,10,635,6,368,4,267,750.194063,60.654657,48.537081,35.21576258
10.12.0.42,4546,10.11.9.208,502,10,619,6,368,4,251,750.194363,60.732391,48.4749563,33.06308161
10.12.0.42,4547,10.11.9.208,502,9,559,6,368,3,191,831.28532,60.05917,49.01832643,25.44157703
10.12.0.42,4548,10.11.9.208,502,9,593,6,368,3,225,831.285578,60.168216,48.92948795,29.91612715
10.12.0.42,4549,10.11.9.208,502,10,623,6,368,4,255,831.285863,60.245998,48.8663164,33.86117033
10.12.0.42,4550,10.11.9.208,502,10,627,6,368,4,259,831.28615,60.324034,48.80310226,34.34783556
10.12.0.42,4551,10.11.9.208,502,9,559,6,368,3,191,834.31563,60.04646,49.02870211,25.44696224
10.12.0.42,4552,10.11.9.208,502,9,593,6,368,3,225,834.3158,60.155647,48.93971135,29.92237786
10.12.0.42,4553,10.11.9.208,502,10,623,6,368,4,255,834.316072,60.249141,48.8637672,33.8594039
10.12.0.42,4554,10.11.9.208,502,10,627,6,368,4,259,834.316483,60.342475,48.78818776,34.33733867
10.12.0.42,4555,10.11.9.208,502,16,"1,076",9,566,7,510,834.316759,60.708418,74.58603187,67.20649515
10.12.0.42,4556,10.11.9.208,502,7,424,5,304,2,120,834.317155,63.005006,38.60010743,15.23688451
10.12.0.42,4557,10.11.9.208,502,7,424,5,304,2,120,834.317313,63.004877,38.60018646,15.23691571
10.12.0.42,4558,10.11.9.208,502,9,544,6,364,3,180,834.317557,63.020261,46.20736179,22.84979429
10.12.0.62,65284,143.166.135.105,80,3,194,3,194,0,0,11.719708,9.001716,172.4115713,0
10.12.0.62,65292,23.0.40.234,80,3,194,3,194,0,0,18.760673,9.006317,172.3234925,0
10.12.0.62,65294,172.217.22.68,80,3,194,3,194,0,0,39.767582,8.992917,172.5802651,0
10.12.0.62,65298,143.166.135.105,80,3,194,3,194,0,0,44.718989,8.990599,172.6247606,0
10.12.0.62,65304,23.0.40.234,80,3,194,3,194,0,0,68.917231,8.997884,172.4849976,0
10.12.0.62,65308,143.166.135.105,80,3,194,3,194,0,0,78.202082,9.000634,172.4322975,0
10.12.0.62,65314,172.217.22.68,80,3,194,3,194,0,0,89.921857,9.007763,172.2958297,0
10.12.0.62,65318,143.166.135.105,80,3,194,3,194,0,0,110.727872,9.003018,172.3866375,0
10.12.0.62,65324,23.0.40.234,80,3,194,3,194,0,0,119.07525,9.004284,172.3623999,0
10.12.0.62,65328,172.217.22.68,80,3,194,3,194,0,0,140.077204,8.997622,172.4900201,0
10.12.0.62,65330,143.166.135.105,80,3,194,3,194,0,0,143.730975,8.994159,172.5564336,0
10.12.0.62,65339,23.0.40.234,80,3,194,3,194,0,0,169.223553,9.006254,172.3246979,0
10.12.0.62,65340,143.166.135.105,80,3,194,3,194,0,0,176.737742,9.003378,172.3797446,0
10.12.0.62,65346,172.217.22.68,80,3,194,3,194,0,0,190.234291,8.998863,172.4662327,0
10.12.0.62,65350,143.166.135.105,80,3,194,3,194,0,0,209.745053,9.005284,172.3432598,0
10.12.0.62,65356,23.0.40.234,80,3,194,3,194,0,0,219.388225,8.999895,172.4464563,0
10.12.0.62,65360,172.217.22.68,80,3,194,3,194,0,0,240.387791,8.997673,172.4890424,0
10.12.0.62,65361,143.166.135.105,80,3,194,3,194,0,0,242.784144,9.007372,172.3033089,0
10.12.0.62,65370,23.0.40.234,80,3,194,3,194,0,0,269.536488,8.999826,172.4477784,0
10.12.0.62,65371,143.166.135.105,80,3,194,3,194,0,0,275.78623,9.000519,172.4345007,0
10.12.0.62,65377,172.217.22.68,80,3,194,3,194,0,0,290.548213,9.003566,172.3761452,0
10.12.0.62,65381,143.166.135.105,80,3,194,3,194,0,0,308.794381,8.998445,172.4742442,0
10.12.0.62,65387,23.0.40.234,80,3,194,3,194,0,0,319.69533,8.997397,172.4943336,0
10.12.0.62,65391,172.217.22.68,80,3,194,3,194,0,0,340.690801,8.996205,172.5171892,0
10.12.0.62,65392,143.166.135.105,80,3,194,3,194,0,0,341.815237,8.993788,172.5635516,0
10.12.0.62,65401,23.0.40.234,80,3,194,3,194,0,0,369.837612,9.009356,172.265365,0
10.12.0.62,65402,143.166.135.105,80,3,194,3,194,0,0,374.817001,9.000079,172.4429308,0
10.12.0.62,65411,172.217.22.68,80,3,194,3,194,0,0,390.846665,8.996567,172.5102475,0
10.12.0.62,65412,143.166.135.105,80,3,194,3,194,0,0,407.843448,8.996012,172.5208904,0
10.12.0.62,65421,23.0.40.234,80,3,194,3,194,0,0,420.374934,8.999377,172.4563823,0
10.12.0.62,65422,143.166.135.105,80,3,194,3,194,0,0,440.845521,9.002141,172.4034316,0
10.12.0.62,65423,172.217.22.68,80,3,194,3,194,0,0,441.378066,8.9966,172.5096147,0
10.12.0.62,65434,23.0.40.234,80,3,194,3,194,0,0,470.521189,9.002233,172.4016697,0
10.12.0.62,65435,143.166.135.105,80,3,194,3,194,0,0,473.849119,8.998605,172.4711775,0
10.12.0.62,65444,172.217.22.68,80,3,194,3,194,0,0,491.533473,8.999387,172.4561906,0
10.12.0.62,65448,143.166.135.105,80,3,194,3,194,0,0,506.867365,9.000568,172.433562,0
10.12.0.62,65454,23.0.40.234,80,3,194,3,194,0,0,520.668437,8.995287,172.5347952,0
10.12.0.62,65458,143.166.135.105,80,3,194,3,194,0,0,539.876052,9.003973,172.3683534,0
10.12.0.62,65459,172.217.22.68,80,3,194,3,194,0,0,541.666391,9.001848,172.4090431,0
10.12.0.62,65468,23.0.40.234,80,3,194,3,194,0,0,571.365461,9.004722,172.354016,0
10.12.0.62,65469,143.166.135.105,80,3,194,3,194,0,0,572.878024,9.002172,172.4028379,0
10.12.0.62,65475,172.217.22.68,80,3,194,3,194,0,0,592.373849,9.003576,172.3759537,0
10.12.0.62,65479,143.166.147.101,80,3,194,3,194,0,0,605.904931,9.006515,172.3197041,0
10.12.0.62,65485,23.0.40.234,80,3,194,3,194,0,0,621.527938,8.997372,172.4948129,0
10.12.0.62,65489,143.166.147.101,80,3,194,3,194,0,0,638.905955,9.000557,172.4337727,0
10.12.0.62,65490,172.217.22.68,80,3,194,3,194,0,0,642.534384,9.006489,172.3202016,0
10.12.0.62,65499,23.0.40.234,80,3,194,3,194,0,0,671.687346,9.001279,172.4199417,0
10.12.0.62,65500,143.166.147.101,80,3,194,3,194,0,0,671.909534,9.001162,172.4221828,0
10.12.0.62,65512,172.217.22.68,80,3,194,3,194,0,0,692.694458,8.992704,172.5843528,0
10.12.0.62,65513,143.166.147.101,80,3,194,3,194,0,0,705.302114,8.997831,172.4860136,0
10.12.0.62,65520,23.0.40.234,80,3,194,3,194,0,0,722.224002,8.999976,172.4449043,0
10.12.0.62,65524,143.166.147.101,80,3,194,3,194,0,0,737.935484,8.997469,172.4929533,0
10.12.0.62,65526,172.217.22.68,80,3,194,3,194,0,0,743.22884,9.007454,172.3017403,0
10.12.0.62,49155,143.166.147.101,80,3,194,3,194,0,0,770.940714,9.002409,172.3982992,0
10.12.0.62,49156,23.0.40.234,80,3,194,3,194,0,0,772.393088,8.995114,172.5381135,0
10.12.0.62,49169,172.217.22.68,80,3,194,3,194,0,0,793.398598,9.008962,172.2728989,0
10.12.0.62,49170,143.166.147.101,80,3,194,3,194,0,0,803.942771,9.003502,172.3773705,0
10.12.0.62,49194,23.0.40.234,80,3,194,3,194,0,0,822.531209,8.999284,172.4581644,0
10.12.0.62,49195,143.166.147.101,80,3,194,3,194,0,0,836.96914,9.009263,172.2671433,0
10.12.0.62,49196,172.217.22.68,80,3,194,3,194,0,0,843.54033,9.001679,172.41228,0
10.12.0.62,49209,143.166.147.101,80,3,194,3,194,0,0,869.969074,8.991533,172.6068291,0
10.12.0.62,49210,23.0.40.234,80,3,194,3,194,0,0,872.677775,9.000036,172.4437547,0
10.12.0.62,49221,172.217.22.68,80,3,194,3,194,0,0,893.67657,9.001616,172.4134866,0
10.12.0.63,3064,95.101.113.32,80,3,186,3,186,0,0,207.095111,8.934497,166.5454698,0
10.12.0.63,3065,95.101.113.42,80,3,186,3,186,0,0,228.062365,9.186546,161.9760027,0
10.12.0.63,3066,95.101.113.24,80,3,186,3,186,0,0,249.280968,9.077853,163.9154104,0
10.12.0.63,3067,95.101.113.41,80,3,186,3,186,0,0,270.281588,9.296377,160.0623555,0
10.12.0.63,3068,95.101.113.34,80,3,186,3,186,0,0,291.719473,9.077724,163.9177397,0
10.12.0.63,3069,95.101.113.33,80,3,186,3,186,0,0,312.829186,9.079321,163.8889076,0
10.12.0.63,3070,95.101.113.26,80,3,186,3,186,0,0,334.048397,8.968564,165.9128485,0
10.12.0.63,3071,95.101.113.40,80,3,186,3,186,0,0,355.048967,9.187236,161.9638377,0
10.12.0.63,3072,95.101.113.27,80,3,186,3,186,0,0,376.377596,9.296694,160.0568976,0
10.12.0.63,3074,10.238.200.37,80,3,186,3,186,0,0,619.331384,9.05162,164.3904627,0
10.12.0.63,3074,10.238.200.37,80,3,186,3,186,0,0,640.415705,9.077099,163.9290262,0
10.12.0.65,3867,95.101.113.48,80,3,186,3,186,0,0,258.767633,8.870422,167.7485017,0
10.12.0.65,3868,95.101.113.49,80,3,186,3,186,0,0,279.670201,9.187382,161.9612638,0
10.12.0.65,3869,95.101.113.8,80,3,186,3,186,0,0,300.891879,9.296107,160.0670044,0
10.12.0.65,3870,95.101.113.10,80,3,186,3,186,0,0,322.328791,9.077415,163.9233196,0
10.12.0.65,3871,95.101.113.41,80,3,186,3,186,0,0,343.438787,9.187019,161.9676633,0
10.12.0.65,3872,95.101.113.9,80,3,186,3,186,0,0,364.673843,8.952831,166.2044106,0
10.12.0.65,3873,95.101.113.42,80,3,186,3,186,0,0,385.659015,8.968441,165.9151239,0
10.12.0.65,3874,95.101.113.40,80,3,186,3,186,0,0,406.659728,9.18743,161.9604177,0
10.12.0.65,3875,95.101.113.43,80,3,186,3,186,0,0,427.990738,9.294693,160.0913554,0
10.12.0.65,3877,10.238.200.37,80,3,186,3,186,0,0,562.531784,9.290165,160.1693834,0
10.12.0.65,3877,10.238.200.37,80,3,186,3,186,0,0,583.964534,9.186283,161.98064,0
10.12.0.71,62286,172.217.22.68,80,1,62,1,62,0,0,2.226666,0,0,0
10.12.0.71,62290,23.0.40.234,80,3,194,3,194,0,0,19.25564,9.003846,172.3707847,0
10.12.0.71,62291,172.217.22.68,80,3,194,3,194,0,0,40.255593,9.001099,172.4233896,0
10.12.0.71,62295,23.0.40.234,80,3,194,3,194,0,0,66.823352,9.007218,172.3062548,0
10.12.0.71,62299,172.217.22.68,80,3,194,3,194,0,0,87.830824,8.999024,172.4631471,0
10.12.0.71,62303,23.0.40.234,80,3,194,3,194,0,0,113.858314,9.003356,172.3801658,0
10.12.0.71,62304,172.217.22.68,80,3,194,3,194,0,0,134.86101,8.995981,172.5214849,0
10.12.0.71,62308,23.0.40.234,80,3,194,3,194,0,0,160.888778,9.00091,172.4270102,0
10.12.0.71,62312,172.217.22.68,80,3,194,3,194,0,0,181.89509,9.004986,172.3489631,0
10.12.0.71,62316,23.0.40.234,80,3,194,3,194,0,0,208.306195,9.001587,172.4140421,0
10.12.0.71,62317,172.217.22.68,80,3,194,3,194,0,0,229.316282,9.002764,172.3915011,0
10.12.0.71,62321,23.0.40.234,80,3,194,3,194,0,0,255.330029,8.999873,172.4468779,0
10.12.0.71,62325,172.217.22.68,80,3,194,3,194,0,0,276.33733,9.000984,172.4255926,0
10.12.0.71,62329,23.0.40.234,80,3,194,3,194,0,0,302.373929,9.00111,172.4231789,0
10.12.0.71,62330,172.217.22.68,80,3,194,3,194,0,0,323.370355,9.006962,172.3111522,0
10.12.0.71,62334,23.0.40.234,80,3,194,3,194,0,0,349.980039,9.007083,172.3088374,0
10.12.0.71,62340,172.217.22.68,80,3,194,3,194,0,0,370.98657,9.000965,172.4259566,0
10.12.0.71,62344,23.0.40.234,80,3,194,3,194,0,0,397.014773,9.004469,172.3588587,0
10.12.0.71,62345,172.217.22.68,80,3,194,3,194,0,0,418.015575,9.001856,172.4088899,0
10.12.0.71,62349,23.0.40.234,80,3,194,3,194,0,0,444.037673,8.995634,172.5281398,0
10.12.0.71,62353,172.217.22.68,80,3,194,3,194,0,0,465.038588,9.00006,172.4432948,0
10.12.0.71,62357,23.0.40.234,80,3,194,3,194,0,0,491.566433,9.000863,172.4279105,0
10.12.0.71,62361,172.217.22.68,80,3,194,3,194,0,0,512.568083,8.99763,172.4898668,0
10.12.0.71,62362,23.0.40.234,80,3,194,3,194,0,0,538.595959,9.000393,172.4369147,0
10.12.0.71,62366,172.217.22.68,80,3,194,3,194,0,0,559.600938,9.000927,172.4266845,0
10.12.0.71,62370,23.0.40.234,80,3,194,3,194,0,0,585.634935,9.002548,172.3956373,0
10.12.0.71,62374,172.217.22.68,80,3,194,3,194,0,0,606.646907,9.003984,172.3681428,0
10.12.0.71,62375,23.0.40.234,80,3,194,3,194,0,0,632.678425,9.000041,172.4436589,0
10.12.0.71,62379,172.217.22.68,80,3,194,3,194,0,0,653.686896,9.003074,172.3855652,0
10.12.0.71,62383,23.0.40.234,80,3,194,3,194,0,0,679.720529,9.003149,172.3841292,0
10.12.0.71,62384,40.77.226.249,443,3,194,3,194,0,0,682.808056,9.006867,172.3129696,0
10.12.0.71,62385,40.77.226.250,443,3,194,3,194,0,0,682.808059,9.006866,172.3129888,0
10.12.0.71,62389,172.217.22.68,80,3,194,3,194,0,0,700.728038,9.000994,172.425401,0
10.12.0.71,62390,40.77.226.249,443,3,194,3,194,0,0,706.389869,9.003574,172.375992,0
10.12.0.71,62391,23.0.40.234,80,3,194,3,194,0,0,726.763951,9.001749,172.4109393,0
10.12.0.71,62395,172.217.22.68,80,3,194,3,194,0,0,747.765313,8.99578,172.5253397,0
10.12.0.71,62399,23.0.40.234,80,3,194,3,194,0,0,773.803348,8.997343,172.4953689,0
10.12.0.71,62403,172.217.22.68,80,3,194,3,194,0,0,794.813521,8.997618,172.4900968,0
10.12.0.71,62407,23.0.40.234,80,3,194,3,194,0,0,820.849612,8.994251,172.5546685,0
10.12.0.71,62408,172.217.22.68,80,3,194,3,194,0,0,841.846373,8.995807,172.5248218,0
10.12.0.71,62412,23.0.40.234,80,3,194,3,194,0,0,867.860202,8.993747,172.5643383,0
10.12.0.71,62416,172.217.22.68,80,3,194,3,194,0,0,888.860294,8.998064,172.4815471,0
10.12.0.122,64131,191.238.240.12,443,3,194,3,194,0,0,338.408317,8.999677,172.4506335,0
10.12.0.141,51592,10.11.1.149,1433,317,"57,111",166,30981,151,26130,0.062121,900.169992,275.3346615,232.2228044
10.12.0.141,50470,23.0.40.234,80,3,194,3,194,0,0,140.341122,8.998765,172.4681109,0
10.12.0.141,50527,23.0.40.234,80,3,194,3,194,0,0,461.35179,9.00679,172.3144428,0
10.12.0.141,50587,23.0.40.234,80,3,194,3,194,0,0,782.375656,9.005562,172.3379396,0
10.12.0.162,54611,23.32.124.29,443,3,194,3,194,0,0,728.239484,9.003313,172.3809891,0
10.12.0.163,4176,10.238.101.79,443,3,186,3,186,0,0,457.64479,8.972186,165.8458708,0
10.12.0.163,4186,10.238.101.79,80,3,186,3,186,0,0,501.324191,9.043071,164.5458716,0
10.12.0.163,4219,10.238.101.79,443,3,186,3,186,0,0,685.213533,9.232844,161.1637758,0
10.12.0.163,4223,10.238.101.79,443,3,186,3,186,0,0,708.890696,9.071454,164.0310363,0
10.12.0.163,4227,10.238.101.79,443,3,186,3,186,0,0,733.601447,8.970265,165.881387,0
10.12.0.163,4228,10.238.101.79,443,3,186,3,186,0,0,756.980967,9.106535,163.3991414,0
10.12.0.163,4232,10.238.101.79,443,3,186,3,186,0,0,780.565218,9.147356,162.6699562,0
10.12.0.163,4236,10.238.101.79,443,3,186,3,186,0,0,807.636325,8.982689,165.6519557,0
10.12.0.184,1392,10.1.1.12,443,3,186,3,186,0,0,4.680529,9.077642,163.9192204,0
10.12.0.184,1393,10.114.1.100,443,3,186,3,186,0,0,25.899434,9.077547,163.9209359,0
10.12.0.184,1394,10.134.1.11,443,3,186,3,186,0,0,47.008816,9.077596,163.9200511,0
10.12.0.184,1395,10.112.1.11,443,3,186,3,186,0,0,68.008857,9.296387,160.0621833,0
10.12.0.184,1396,10.120.1.1,443,3,186,3,186,0,0,89.446435,9.077517,163.9214776,0
10.12.0.184,1397,10.115.1.6,443,3,186,3,186,0,0,110.555912,9.077518,163.9214596,0
10.12.0.184,1398,10.82.1.30,443,3,186,3,186,0,0,131.774958,9.077177,163.9276176,0
10.12.0.184,1399,10.11.1.12,443,3,186,3,186,0,0,152.993581,9.296078,160.0675037,0
10.12.0.184,1400,10.80.1.65,443,3,186,3,186,0,0,174.321334,9.077851,163.9154465,0
10.12.0.184,1401,10.121.1.5,443,3,186,3,186,0,0,195.430836,9.29646,160.0609264,0
10.12.0.184,1402,10.86.1.12,443,3,186,3,186,0,0,216.868438,8.968261,165.918454,0
10.12.0.184,1403,10.119.1.3,443,3,186,3,186,0,0,237.868666,8.968011,165.9230793,0
10.12.0.184,1404,10.130.1.3,443,3,186,3,186,0,0,258.868321,8.968328,165.9172144,0
10.12.0.184,1405,10.136.1.1,443,3,186,3,186,0,0,279.869192,9.076987,163.9310489,0
10.12.0.184,1406,10.238.101.79,443,3,186,3,186,0,0,301.087399,8.968131,165.9208591,0
10.12.0.184,1407,10.95.1.18,443,3,186,3,186,0,0,367.142706,8.97541,165.7862983,0
10.12.0.184,1408,10.116.1.1,443,3,186,3,186,0,0,390.402608,9.012351,165.1067518,0
10.12.0.184,1409,10.113.10.1,443,3,186,3,186,0,0,413.699654,9.012263,165.108364,0
10.12.0.184,1410,10.33.10.8,443,3,186,3,186,0,0,436.996337,9.231237,161.1918316,0
10.12.0.184,1411,10.1.1.12,443,3,186,3,186,0,0,460.621147,8.903396,167.12724,0
10.12.0.184,1412,10.114.1.100,443,3,186,3,186,0,0,483.810169,9.011255,165.1268331,0
10.12.0.184,1413,10.134.1.11,443,3,186,3,186,0,0,507.107478,9.120167,163.1549071,0
10.12.0.184,1414,10.112.1.11,443,3,186,3,186,0,0,530.621638,9.013042,165.0940936,0
10.12.0.184,1415,10.95.32.32,443,3,186,3,186,0,0,554.027618,8.903227,167.1304124,0
10.12.0.184,1416,10.120.1.1,443,3,186,3,186,0,0,577.215033,8.90349,167.1254755,0
10.12.0.184,1417,10.115.1.6,443,3,186,3,186,0,0,600.402969,9.012367,165.1064587,0
10.12.0.184,1418,10.82.1.30,443,3,186,3,186,0,0,623.700026,9.012228,165.1090052,0
10.12.0.184,1419,10.11.1.12,443,3,186,3,186,0,0,646.996557,9.231428,161.1884965,0
10.12.0.184,1420,10.80.1.65,443,3,186,3,186,0,0,670.621628,8.903129,167.132252,0
10.12.0.184,1421,10.121.1.5,443,3,186,3,186,0,0,693.91829,9.122168,163.1191182,0
10.12.0.184,1422,10.86.1.12,443,3,186,3,186,0,0,717.324815,8.903227,167.1304124,0
10.12.0.184,1423,10.119.1.3,443,3,186,3,186,0,0,740.512207,9.012614,165.1019338,0
10.12.0.184,1424,10.130.1.3,443,3,186,3,186,0,0,763.809176,9.012654,165.101201,0
10.12.0.184,1425,10.136.1.1,443,3,186,3,186,0,0,787.215346,8.903276,167.1294926,0
10.12.0.184,1426,10.238.101.79,443,3,186,3,186,0,0,810.40329,9.012284,165.1079793,0
10.12.0.184,1427,10.95.32.32,443,3,186,3,186,0,0,834.357969,9.010767,165.1357759,0
10.12.0.184,1428,10.95.1.18,443,3,186,3,186,0,0,855.401368,9.076762,163.9351125,0
10.12.0.184,1429,10.116.1.1,443,3,186,3,186,0,0,876.50992,9.296419,160.0616323,0
10.12.0.184,1430,10.113.10.1,443,2,124,2,124,0,0,897.947505,3.061915,323.9802542,0
10.12.0.190,4381,10.95.32.32,443,3,186,3,186,0,0,113.749146,9.074378,163.9781812,0
10.12.0.190,4382,10.80.1.65,443,3,186,3,186,0,0,134.855303,9.296697,160.056846,0
10.12.0.201,58137,172.217.22.68,80,1,62,1,62,0,0,4.27654,0,0,0
10.12.0.201,58141,23.0.40.234,80,3,194,3,194,0,0,21.306025,9.002541,172.3957714,0
10.12.0.201,58145,172.217.22.68,80,3,194,3,194,0,0,42.312409,9.005907,172.3313376,0
10.12.0.201,58151,23.0.40.234,80,3,194,3,194,0,0,68.343446,9.002822,172.3903905,0
10.12.0.201,58152,172.217.22.68,80,3,194,3,194,0,0,89.353989,9.000789,172.4293281,0
10.12.0.201,58158,23.0.40.234,80,3,194,3,194,0,0,115.902825,8.998119,172.4804929,0
10.12.0.201,58162,172.217.22.68,80,3,194,3,194,0,0,136.907446,9.008023,172.2908567,0
10.12.0.201,58166,23.0.40.234,80,3,194,3,194,0,0,162.952163,9.006307,172.3236838,0
10.12.0.201,58167,172.217.22.68,80,3,194,3,194,0,0,183.959072,9.000026,172.4439463,0
10.12.0.201,58171,23.0.40.234,80,3,194,3,194,0,0,209.997093,9.000061,172.4432757,0
10.12.0.201,58175,172.217.22.68,80,3,194,3,194,0,0,231.001762,8.996913,172.5036132,0
10.12.0.201,58179,23.0.40.234,80,3,194,3,194,0,0,257.545023,8.999902,172.4463222,0
10.12.0.201,58180,172.217.22.68,80,3,194,3,194,0,0,278.55079,9.000542,172.4340601,0
10.12.0.201,58184,23.0.40.234,80,3,194,3,194,0,0,304.588681,8.994741,172.5452684,0
10.12.0.201,58188,172.217.22.68,80,3,194,3,194,0,0,325.585182,9.005869,172.3320648,0
10.12.0.201,58192,23.0.40.234,80,3,194,3,194,0,0,351.627894,9.002139,172.4034699,0
10.12.0.201,58195,172.217.22.68,80,3,194,3,194,0,0,372.6358,9.001871,172.4086026,0
10.12.0.201,58199,23.0.40.234,80,3,194,3,194,0,0,398.676403,8.998171,172.4794961,0
10.12.0.201,58203,172.217.22.68,80,3,194,3,194,0,0,419.677517,8.992801,172.5824913,0
10.12.0.201,58207,23.0.40.234,80,3,194,3,194,0,0,445.683394,9.006953,172.3113244,0
10.12.0.201,58208,172.217.22.68,80,3,194,3,194,0,0,466.685957,9.000935,172.4265312,0
10.12.0.201,58212,23.0.40.234,80,3,194,3,194,0,0,492.705221,8.999691,172.4503652,0
10.12.0.201,58216,172.217.22.68,80,3,194,3,194,0,0,513.714695,8.998767,172.4680726,0
10.12.0.201,58217,23.32.124.29,443,3,194,3,194,0,0,523.438367,9.00703,172.3098513,0
10.12.0.201,58221,23.0.40.234,80,3,194,3,194,0,0,540.113726,8.998807,172.4673059,0
10.12.0.201,58225,172.217.22.68,80,3,194,3,194,0,0,561.119374,9.009794,172.2569906,0
10.12.0.201,58226,23.0.40.234,80,3,194,3,194,0,0,587.154163,8.998967,172.4642395,0
10.12.0.201,58230,172.217.22.68,80,3,194,3,194,0,0,608.156882,8.998871,172.4660794,0
10.12.0.201,58234,23.0.40.234,80,3,194,3,194,0,0,634.172487,9.001251,172.420478,0
10.12.0.201,58238,172.217.22.68,80,3,194,3,194,0,0,655.1776,9.00675,172.315208,0
10.12.0.201,58241,23.0.40.234,80,3,194,3,194,0,0,681.587802,8.995473,172.5312277,0
10.12.0.201,58245,172.217.22.68,80,3,194,3,194,0,0,702.589905,9.008059,172.2901682,0
10.12.0.201,58249,23.0.40.234,80,3,194,3,194,0,0,728.641235,8.998683,172.4696825,0
10.12.0.201,58253,172.217.22.68,80,3,194,3,194,0,0,749.637598,9.000015,172.444157,0
10.12.0.201,58254,23.0.40.234,80,3,194,3,194,0,0,775.674502,9.000076,172.4429883,0
10.12.0.201,58258,172.217.22.68,80,3,194,3,194,0,0,796.678433,9.007696,172.2971113,0
10.12.0.201,58262,23.0.40.234,80,3,194,3,194,0,0,822.722747,9.001432,172.417011,0
10.12.0.201,58266,172.217.22.68,80,3,194,3,194,0,0,843.729954,8.990846,172.6200182,0
10.12.0.201,58270,23.0.40.234,80,3,194,3,194,0,0,870.134516,9.000375,172.4372596,0
10.12.0.201,58271,172.217.22.68,80,3,194,3,194,0,0,891.141182,8.994125,172.5570859,0
10.12.0.202,53601,172.217.22.68,80,2,128,2,128,0,0,2.491927,5.997267,170.7444408,0
10.12.0.202,53605,23.0.40.234,80,3,194,3,194,0,0,25.530123,8.99907,172.4622655,0
10.12.0.202,53609,172.217.22.68,80,3,194,3,194,0,0,46.533068,8.998646,172.4703917,0
10.12.0.202,53613,23.0.40.234,80,3,194,3,194,0,0,72.573747,8.997832,172.4859944,0
10.12.0.202,53614,172.217.22.68,80,3,194,3,194,0,0,93.572352,8.998806,172.4673251,0
10.12.0.202,53618,23.0.40.234,80,3,194,3,194,0,0,119.614573,8.999472,172.4545618,0
10.12.0.202,53622,172.217.22.68,80,3,194,3,194,0,0,140.622661,9.005878,172.3318926,0
10.12.0.202,53626,23.0.40.234,80,3,194,3,194,0,0,166.664726,9.000794,172.4292324,0
10.12.0.202,53627,172.217.22.68,80,3,194,3,194,0,0,187.673378,8.995711,172.526663,0
10.12.0.202,53631,23.0.40.234,80,3,194,3,194,0,0,213.712957,8.999978,172.444866,0
10.12.0.202,53635,172.217.22.68,80,3,194,3,194,0,0,234.715686,8.999752,172.4491964,0
10.12.0.202,53639,23.0.40.234,80,3,194,3,194,0,0,260.754442,8.999885,172.4466479,0
10.12.0.202,53640,172.217.22.68,80,3,194,3,194,0,0,281.757962,9.00296,172.387748,0
10.12.0.202,53644,23.0.40.234,80,3,194,3,194,0,0,307.772586,8.993343,172.5720903,0
10.12.0.202,53650,172.217.22.68,80,3,194,3,194,0,0,328.771676,9.000652,172.4319527,0
10.12.0.202,53654,23.0.40.234,80,3,194,3,194,0,0,354.806986,9.000252,172.4396161,0
10.12.0.202,53655,172.217.22.68,80,3,194,3,194,0,0,375.81091,9.005867,172.3321031,0
10.12.0.202,53659,23.0.40.234,80,3,194,3,194,0,0,401.841577,9.009098,172.2702983,0
10.12.0.202,53663,172.217.22.68,80,3,194,3,194,0,0,422.854474,9.001646,172.412912,0
10.12.0.202,53667,23.0.40.234,80,3,194,3,194,0,0,448.889954,9.003157,172.383976,0
10.12.0.202,53668,172.217.22.68,80,3,194,3,194,0,0,469.898833,9.005876,172.3319308,0
10.12.0.202,53672,23.32.124.29,443,3,194,3,194,0,0,493.082334,9.00098,172.4256692,0
10.12.0.202,53673,23.0.40.234,80,3,194,3,194,0,0,495.946657,8.993973,172.5600021,0
10.12.0.202,53677,172.217.22.68,80,3,194,3,194,0,0,516.944402,9.002688,172.3929564,0
10.12.0.202,53681,23.0.40.234,80,3,194,3,194,0,0,542.989046,9.000958,172.4260906,0
10.12.0.202,53682,172.217.22.68,80,3,194,3,194,0,0,563.994284,9.000192,172.4407657,0
10.12.0.202,53686,23.0.40.234,80,3,194,3,194,0,0,590.032341,8.995165,172.5371352,0
10.12.0.202,53690,172.217.22.68,80,3,194,3,194,0,0,611.03328,9.000623,172.4325083,0
10.12.0.202,53694,23.0.40.234,80,3,194,3,194,0,0,637.074758,9.000189,172.4408232,0
10.12.0.202,53695,172.217.22.68,80,3,194,3,194,0,0,658.075642,8.997726,172.4880264,0
10.12.0.202,53699,23.0.40.234,80,3,194,3,194,0,0,684.114879,9.003496,172.3774854,0
10.12.0.202,53703,172.217.22.68,80,3,194,3,194,0,0,705.122826,9.000978,172.4257075,0
10.12.0.202,53707,23.0.40.234,80,3,194,3,194,0,0,731.170131,9.000589,172.4331597,0
10.12.0.202,53711,172.217.22.68,80,3,194,3,194,0,0,752.169438,9.000823,172.4286768,0
10.12.0.202,53712,23.0.40.234,80,3,194,3,194,0,0,778.209251,9.007835,172.2944526,0
10.12.0.202,53716,172.217.22.68,80,3,194,3,194,0,0,799.220823,9.001797,172.4100199,0
10.12.0.202,53720,23.0.40.234,80,3,194,3,194,0,0,825.75881,8.998813,172.467191,0
10.12.0.202,53724,172.217.22.68,80,3,194,3,194,0,0,846.767699,9.000353,172.4376811,0
10.12.0.202,53725,23.0.40.234,80,3,194,3,194,0,0,872.79662,8.998521,172.4727875,0
10.12.0.202,53729,172.217.22.68,80,3,194,3,194,0,0,893.808665,9.001828,172.4094262,0
10.12.0.251,3971,10.114.1.100,443,3,186,3,186,0,0,12.890598,8.885455,167.4646937,0
10.12.0.251,3972,10.82.1.30,443,3,186,3,186,0,0,51.061707,8.885366,167.4663711,0
10.12.0.251,3973,10.119.1.3,443,3,186,3,186,0,0,89.232757,8.99469,165.4309376,0
10.12.0.251,3974,10.134.1.11,443,3,186,3,186,0,0,127.51306,8.99475,165.4298341,0
10.12.0.251,3975,10.113.10.1,443,3,186,3,186,0,0,165.684026,8.885504,167.4637702,0
10.12.0.251,3976,10.115.1.6,443,3,186,3,186,0,0,203.855109,8.885377,167.4661638,0
10.12.0.251,3977,10.116.1.1,443,3,186,3,186,0,0,242.026335,8.99461,165.432409,0
10.12.0.251,3978,10.12.128.164,139,32,"4,940",0,0,32,4940,272.779802,0.014543,0,2717458.571
10.12.0.251,3979,10.80.1.65,443,3,186,3,186,0,0,280.306655,8.994648,165.4317101,0
10.12.0.251,3980,10.86.1.12,443,3,186,3,186,0,0,318.477611,8.885386,167.4659942,0
10.12.0.251,3981,10.112.1.11,443,3,186,3,186,0,0,356.648546,8.994899,165.4270937,0
10.12.0.251,3982,10.95.32.32,443,3,186,3,186,0,0,395.803315,8.995463,165.4167217,0
10.12.0.251,3983,10.80.1.65,443,3,186,3,186,0,0,416.721425,9.07688,163.9329814,0
10.12.0.251,3984,10.82.1.30,443,3,186,3,186,0,0,437.72077,9.077109,163.9288456,0
10.12.0.251,3985,10.130.1.3,443,3,186,3,186,0,0,458.720273,9.077182,163.9275273,0
10.12.0.251,3986,10.119.1.3,443,3,186,3,186,0,0,479.719723,9.077168,163.9277801,0
10.12.0.251,3987,10.116.1.1,443,3,186,3,186,0,0,500.719416,9.077048,163.9299473,0
10.12.0.251,3988,10.1.1.12,443,3,186,3,186,0,0,521.718897,9.077102,163.928972,0
10.12.0.251,3989,10.120.1.1,443,3,186,3,186,0,0,542.718354,9.077127,163.9285206,0
10.12.0.251,3990,10.114.1.100,443,3,186,3,186,0,0,563.717906,9.077207,163.9270758,0
10.12.0.251,3991,10.238.101.79,443,3,186,3,186,0,0,584.71753,9.077131,163.9284483,0
10.12.0.251,3992,10.86.1.12,443,3,186,3,186,0,0,605.716963,9.077137,163.92834,0
10.12.0.251,3993,10.134.1.11,443,3,186,3,186,0,0,626.716506,9.077218,163.9268772,0
10.12.0.251,3994,10.112.1.11,443,3,186,3,186,0,0,647.716033,9.077212,163.9269855,0
10.12.0.251,3995,10.95.1.18,443,3,186,3,186,0,0,668.715631,9.07705,163.9299111,0
10.12.0.251,3996,10.11.1.12,443,3,186,3,186,0,0,689.715141,9.077026,163.9303446,0
10.12.0.251,3997,10.121.1.5,443,3,186,3,186,0,0,710.714611,9.07722,163.926841,0
10.12.0.251,3998,10.115.1.6,443,3,186,3,186,0,0,731.714154,9.077146,163.9281774,0
10.12.0.251,3999,10.136.1.1,443,3,186,3,186,0,0,752.713715,9.077153,163.928051,0
10.12.0.251,4000,10.113.10.1,443,3,186,3,186,0,0,773.713192,9.077218,163.9268772,0
10.12.0.251,4001,10.33.10.8,443,3,186,3,186,0,0,794.712816,9.077075,163.9294597,0
10.12.0.252,1426,10.12.0.18,443,1,60,1,60,0,0,558.573637,0,0,0
10.12.0.252,1543,10.12.0.18,443,3,276,3,276,0,0,558.574605,0.003182,0,0
10.12.0.252,1427,10.12.0.178,443,1,60,1,60,0,0,558.576683,0,0,0
10.12.0.252,1444,10.12.0.240,443,1,60,1,60,0,0,558.584636,0,0,0
10.12.0.252,1544,10.12.0.40,80,3,315,3,315,0,0,558.58489,0.001058,0,0
10.12.0.252,1545,10.12.0.36,80,3,315,3,315,0,0,558.585367,0.001182,0,0
10.12.0.252,1546,10.12.0.38,80,1,62,1,62,0,0,558.589411,0,0,0
10.12.0.252,1547,10.12.0.39,80,1,62,1,62,0,0,558.589593,0,0,0
10.12.0.252,1549,10.12.0.59,80,1,62,1,62,0,0,558.589788,0,0,0
10.12.0.252,1548,10.12.0.60,80,4,375,4,375,0,0,558.590203,0.026082,115021.8542,0
10.12.0.252,1449,10.12.0.254,80,2,120,1,60,1,60,559.001288,0.000147,0,0
10.12.0.252,1448,10.12.0.139,80,1,60,1,60,0,0,559.010639,0,0,0
10.12.0.252,1553,10.12.0.80,80,3,315,3,315,0,0,559.010816,0.001153,0,0
10.12.0.252,1554,10.12.0.79,80,3,315,3,315,0,0,559.011867,0.001111,0,0
10.12.0.252,1555,10.12.0.135,443,3,276,3,276,0,0,559.013447,0.001759,0,0
10.12.0.252,1451,10.12.0.17,443,1,60,1,60,0,0,559.091778,0,0,0
10.12.0.252,1558,10.12.0.177,443,3,276,3,276,0,0,559.093163,0.001784,0,0
10.12.0.252,1439,10.12.0.200,443,1,60,1,60,0,0,559.533022,0,0,0
10.12.0.252,1452,10.12.1.125,443,1,60,1,60,0,0,559.535038,0,0,0
10.12.0.252,1561,10.12.0.199,443,3,276,3,276,0,0,559.535213,0.001744,0,0
10.12.0.252,1562,10.12.0.180,443,3,276,3,276,0,0,559.536929,0.001627,0,0
10.12.0.252,1564,10.12.0.254,80,16,"2,804",8,755,8,2049,559.746812,0.231231,26121.06508,70890.14881
10.12.0.252,1453,10.12.0.134,443,1,60,1,60,0,0,559.747432,0,0,0
10.12.0.252,1569,10.12.0.254,80,19,"3,292",10,731,9,2561,559.97894,4.392772,1331.277835,4664.025358
10.12.0.252,1613,10.12.0.254,80,12,"1,490",7,558,5,932,565.437093,3.390646,1316.563274,2198.990989
10.12.0.252,1728,10.12.0.254,80,12,"1,520",7,568,5,952,580.351135,0.957458,4745.900081,7954.395911
10.12.0.252,1733,10.12.0.254,80,14,"2,530",8,763,6,1767,581.915062,60.21538,101.3694508,234.7572995
10.12.0.253,61548,92.123.194.164,80,3,194,3,194,0,0,185.369997,8.999716,172.4498862,0
10.12.0.253,61551,23.37.43.27,80,3,194,3,194,0,0,200.748339,8.994631,172.5473785,0
10.12.0.253,61552,92.123.194.116,80,2,132,2,132,0,0,206.371101,2.999887,352.0132592,0
10.12.0.253,61553,23.37.37.163,80,2,132,2,132,0,0,210.749236,2.997025,352.3494132,0
10.12.0.253,61622,92.123.194.164,80,3,194,3,194,0,0,759.75388,9.000703,172.4309757,0
10.12.0.253,61627,23.37.43.27,80,3,194,3,194,0,0,774.761684,8.999969,172.4450384,0
10.12.0.253,61628,92.123.194.116,80,2,132,2,132,0,0,780.754758,2.999907,352.0109123,0
10.12.0.253,61629,23.37.37.163,80,2,132,2,132,0,0,784.758936,3.000138,351.9838087,0
10.12.1.124,3072,10.1.1.2,502,3,192,3,192,0,0,0.587889,31.951092,48.0734743,0
10.12.1.124,4353,10.1.1.3,502,1,64,1,64,0,0,1.808717,0,0,0
10.12.1.124,4353,10.1.1.3,502,5,320,5,320,0,0,1.808721,146.851948,17.43252326,0
10.12.1.124,4608,10.1.1.2,502,1,64,1,64,0,0,4.578629,0,0,0
10.12.1.124,4608,10.1.1.2,502,5,320,5,320,0,0,4.578632,104.851508,24.41548099,0
10.12.1.124,3073,10.1.1.3,502,1,64,1,64,0,0,8.798581,0,0,0
10.12.1.124,3073,10.1.1.3,502,5,320,5,320,0,0,8.798591,90.901409,28.16237975,0
10.12.1.124,4224,10.1.1.2,502,1,64,1,64,0,0,11.56861,0,0,0
10.12.1.124,4224,10.1.1.2,502,5,320,5,320,0,0,11.568622,104.851607,24.41545793,0
10.12.1.124,3585,10.1.1.3,502,1,64,1,64,0,0,15.790415,0,0,0
10.12.1.124,3585,10.1.1.3,502,5,320,5,320,0,0,15.790425,146.850343,17.43271379,0
10.12.1.124,3840,10.1.1.2,502,1,64,1,64,0,0,18.558834,0,0,0
10.12.1.124,3840,10.1.1.2,502,5,320,5,320,0,0,18.558837,104.851516,24.41547912,0
10.12.1.124,3329,10.1.1.3,502,1,64,1,64,0,0,22.788894,0,0,0
10.12.1.124,3329,10.1.1.3,502,5,320,5,320,0,0,22.788896,34.961353,73.22371076,0
10.12.1.124,4352,10.1.1.2,502,1,64,1,64,0,0,25.548908,0,0,0
10.12.1.124,4352,10.1.1.2,502,5,320,5,320,0,0,25.548911,34.950482,73.24648627,0
10.12.1.124,3969,10.1.1.3,502,1,64,1,64,0,0,29.779054,0,0,0
10.12.1.124,3969,10.1.1.3,502,5,320,5,320,0,0,29.779058,125.87179,20.3381552,0
10.12.1.124,3072,10.1.1.2,502,5,320,5,320,0,0,32.538983,104.851513,24.41547982,0
10.12.1.124,4481,10.1.1.3,502,1,64,1,64,0,0,36.769026,0,0,0
10.12.1.124,4481,10.1.1.3,502,5,320,5,320,0,0,36.769029,34.970575,73.20440113,0
10.12.1.124,3584,10.1.1.2,502,1,64,1,64,0,0,39.529172,0,0,0
10.12.1.124,3584,10.1.1.2,502,5,320,5,320,0,0,39.529175,34.950494,73.24646112,0
10.12.1.124,4097,10.1.1.3,502,1,64,1,64,0,0,43.759987,0,0,0
10.12.1.124,4097,10.1.1.3,502,5,320,5,320,0,0,43.759991,34.969779,73.20606744,0
10.12.1.124,3200,10.1.1.2,502,1,64,1,64,0,0,46.51926,0,0,0
10.12.1.124,3200,10.1.1.2,502,5,320,5,320,0,0,46.519263,34.95049,73.24646951,0
10.12.1.124,3713,10.1.1.3,502,1,64,1,64,0,0,50.759306,0,0,0
10.12.1.124,3713,10.1.1.3,502,5,320,5,320,0,0,50.759309,160.822324,15.91818807,0
10.12.1.124,4736,10.1.1.2,502,1,64,1,64,0,0,53.509223,0,0,0
10.12.1.124,4736,10.1.1.2,502,5,320,5,320,0,0,53.509224,125.831939,20.3445963,0
10.12.1.124,3329,10.1.1.3,502,5,320,5,320,0,0,57.750252,160.821568,15.9182629,0
10.12.1.124,4352,10.1.1.2,502,5,320,5,320,0,0,60.499394,34.95073,73.24596654,0
10.12.1.124,4865,10.1.1.3,502,1,64,1,64,0,0,64.749541,0,0,0
10.12.1.124,4865,10.1.1.3,502,5,320,5,320,0,0,64.749544,286.663987,8.930316036,0
10.12.1.124,3968,10.1.1.2,502,1,64,1,64,0,0,67.489621,0,0,0
10.12.1.124,3968,10.1.1.2,502,5,320,5,320,0,0,67.489626,125.831669,20.34463995,0
10.12.1.124,4481,10.1.1.3,502,5,320,5,320,0,0,71.739606,251.713482,10.17029354,0
10.12.1.124,3584,10.1.1.2,502,5,320,5,320,0,0,74.479671,160.802247,15.92017554,0
10.12.1.124,4097,10.1.1.3,502,5,320,5,320,0,0,78.729775,125.861801,20.33976933,0
10.12.1.124,3200,10.1.1.2,502,5,320,5,320,0,0,81.469755,356.545108,7.180017178,0
10.12.1.124,3841,10.1.1.3,502,1,64,1,64,0,0,85.719792,0,0,0
10.12.1.124,3841,10.1.1.3,502,5,320,5,320,0,0,85.719794,34.95116,73.2450654,0
10.12.1.124,4864,10.1.1.2,502,1,64,1,64,0,0,88.459891,0,0,0
10.12.1.124,4864,10.1.1.2,502,5,320,5,320,0,0,88.459894,139.821931,18.3090019,0
10.12.1.124,3457,10.1.1.3,502,1,64,1,64,0,0,92.709903,0,0,0
10.12.1.124,3457,10.1.1.3,502,5,320,5,320,0,0,92.709906,34.96132,73.22377988,0
10.12.1.124,4352,10.1.1.2,502,5,320,5,320,0,0,95.450127,90.881072,28.16868181,0
10.12.1.124,3073,10.1.1.3,502,5,320,5,320,0,0,99.700003,34.970484,73.20459162,0
10.12.1.124,4096,10.1.1.2,502,1,64,1,64,0,0,102.439986,0,0,0
10.12.1.124,4096,10.1.1.2,502,5,320,5,320,0,0,102.439987,104.862245,24.41298105,0
10.12.1.124,4609,10.1.1.3,502,1,64,1,64,0,0,106.690096,0,0,0
10.12.1.124,4609,10.1.1.3,502,5,320,5,320,0,0,106.690099,34.971239,73.20301119,0
10.12.1.124,4608,10.1.1.2,502,5,320,5,320,0,0,109.430144,34.951244,73.24488937,0
10.12.1.124,4225,10.1.1.3,502,1,64,1,64,0,0,113.680162,0,0,0
10.12.1.124,4225,10.1.1.3,502,5,320,5,320,0,0,113.680163,125.871839,20.33814728,0
10.12.1.124,4224,10.1.1.2,502,5,320,5,320,0,0,116.42023,34.960528,73.2254387,0
10.12.1.124,3841,10.1.1.3,502,5,320,5,320,0,0,120.67096,125.871134,20.33826119,0
10.12.1.124,3840,10.1.1.2,502,5,320,5,320,0,0,123.410355,34.960436,73.2256314,0
10.12.1.124,3457,10.1.1.3,502,5,320,5,320,0,0,127.671229,125.861765,20.33977515,0
10.12.1.124,3456,10.1.1.2,502,1,64,1,64,0,0,130.400436,0,0,0
10.12.1.124,3456,10.1.1.2,502,5,320,5,320,0,0,130.400438,34.960445,73.22561255,0
10.12.1.124,3073,10.1.1.3,502,5,320,5,320,0,0,134.67049,90.891303,28.16551106,0
10.12.1.124,3072,10.1.1.2,502,5,320,5,320,0,0,137.390499,34.960535,73.22542404,0
10.12.1.124,4609,10.1.1.3,502,5,320,5,320,0,0,141.661341,90.891327,28.16550362,0
10.12.1.124,4608,10.1.1.2,502,5,320,5,320,0,0,144.381391,125.85103,20.34151012,0
10.12.1.124,4353,10.1.1.3,502,5,320,5,320,0,0,148.660672,34.960528,73.2254387,0
10.12.1.124,4224,10.1.1.2,502,5,320,5,320,0,0,151.380762,125.84174,20.34301179,0
10.12.1.124,3969,10.1.1.3,502,5,320,5,320,0,0,155.650852,34.960413,73.22567957,0
10.12.1.124,3840,10.1.1.2,502,5,320,5,320,0,0,158.370794,90.891405,28.16547945,0
10.12.1.124,3585,10.1.1.3,502,5,320,5,320,0,0,162.64077,34.960688,73.22510358,0
10.12.1.124,3456,10.1.1.2,502,5,320,5,320,0,0,165.360886,90.891345,28.16549805,0
10.12.1.124,3201,10.1.1.3,502,1,64,1,64,0,0,169.631024,0,0,0
10.12.1.124,3201,10.1.1.3,502,5,320,5,320,0,0,169.631025,125.861744,20.33977854,0
10.12.1.124,3072,10.1.1.2,502,5,320,5,320,0,0,172.351034,90.891227,28.16553461,0
10.12.1.124,4737,10.1.1.3,502,1,64,1,64,0,0,176.621809,0,0,0
10.12.1.124,4737,10.1.1.3,502,5,320,5,320,0,0,176.62181,125.861067,20.33988795,0
10.12.1.124,4736,10.1.1.2,502,5,320,5,320,0,0,179.341167,34.960486,73.22552667,0
10.12.1.124,4353,10.1.1.3,502,5,320,5,320,0,0,183.621203,125.851827,20.3413813,0
10.12.1.124,4352,10.1.1.2,502,5,320,5,320,0,0,186.331205,265.663861,9.636237275,0
10.12.1.124,3969,10.1.1.3,502,5,320,5,320,0,0,190.611268,125.851838,20.34137952,0
10.12.1.124,3968,10.1.1.2,502,5,320,5,320,0,0,193.321296,139.83206,18.30767565,0
10.12.1.124,3585,10.1.1.3,502,5,320,5,320,0,0,197.601461,90.901251,28.1624287,0
10.12.1.124,4480,10.1.1.2,502,1,64,1,64,0,0,200.3114,0,0,0
10.12.1.124,4480,10.1.1.2,502,5,320,5,320,0,0,200.311403,160.802303,15.92017,0
10.12.1.124,4097,10.1.1.3,502,5,320,5,320,0,0,204.591577,160.80298,15.92010297,0
10.12.1.124,4096,10.1.1.2,502,5,320,5,320,0,0,207.302233,34.969763,73.20610094,0
10.12.1.124,3713,10.1.1.3,502,5,320,5,320,0,0,211.581635,125.851678,20.34140538,0
10.12.1.124,4736,10.1.1.2,502,5,320,5,320,0,0,214.301658,104.871574,24.41080936,0
10.12.1.124,3329,10.1.1.3,502,5,320,5,320,0,0,218.571825,125.851673,20.34140619,0
10.12.1.124,3328,10.1.1.2,502,1,64,1,64,0,0,221.291648,0,0,0
10.12.1.124,3328,10.1.1.2,502,5,320,5,320,0,0,221.291659,125.84194,20.34297946,0
10.12.1.124,3073,10.1.1.3,502,5,320,5,320,0,0,225.561795,34.970476,73.20460837,0
10.12.1.124,4864,10.1.1.2,502,5,320,5,320,0,0,228.281828,125.841931,20.34298091,0
10.12.1.124,4609,10.1.1.3,502,5,320,5,320,0,0,232.552671,34.969701,73.20623073,0
10.12.1.124,3584,10.1.1.2,502,5,320,5,320,0,0,235.281919,90.881378,28.16858697,0
10.12.1.124,4225,10.1.1.3,502,5,320,5,320,0,0,239.552006,34.960427,73.22565025,0
10.12.1.124,4096,10.1.1.2,502,5,320,5,320,0,0,242.272001,125.831824,20.34461489,0
10.12.1.124,3841,10.1.1.3,502,5,320,5,320,0,0,246.542094,34.961225,73.22397885,0
10.12.1.124,3840,10.1.1.2,502,5,320,5,320,0,0,249.262202,34.951157,73.24507169,0
10.12.1.124,3457,10.1.1.3,502,5,320,5,320,0,0,253.532998,125.850954,20.3415224,0
10.12.1.124,3456,10.1.1.2,502,5,320,5,320,0,0,256.252234,34.96051,73.2254764,0
10.12.1.124,3073,10.1.1.3,502,5,320,5,320,0,0,260.532274,125.841938,20.34297978,0
10.12.1.124,3072,10.1.1.2,502,5,320,5,320,0,0,263.242263,34.960502,73.22549316,0
10.12.1.124,4609,10.1.1.3,502,5,320,5,320,0,0,267.522375,125.84178,20.34300532,0
10.12.1.124,4608,10.1.1.2,502,5,320,5,320,0,0,270.232424,34.96049,73.22551829,0
10.12.1.124,4225,10.1.1.3,502,5,320,5,320,0,0,274.512434,125.841791,20.34300354,0
10.12.1.124,4224,10.1.1.2,502,5,320,5,320,0,0,277.222505,34.960513,73.22547012,0
10.12.1.124,3841,10.1.1.3,502,5,320,5,320,0,0,281.503322,90.89057,28.16573821,0
10.12.1.124,3840,10.1.1.2,502,5,320,5,320,0,0,284.213362,104.860715,24.41333725,0
10.12.1.124,3585,10.1.1.3,502,5,320,5,320,0,0,288.502717,139.812012,18.31030083,0
10.12.1.124,3456,10.1.1.2,502,5,320,5,320,0,0,291.212745,125.831802,20.34461845,0
10.12.1.124,3201,10.1.1.3,502,5,320,5,320,0,0,295.49277,34.950567,73.24630814,0
10.12.1.124,3072,10.1.1.2,502,5,320,5,320,0,0,298.202766,104.851519,24.41547843,0
10.12.1.124,4737,10.1.1.3,502,5,320,5,320,0,0,302.48288,265.674551,9.63584954,0
10.12.1.124,4608,10.1.1.2,502,5,320,5,320,0,0,305.192918,104.852255,24.41530704,0
10.12.1.124,4353,10.1.1.3,502,5,320,5,320,0,0,309.473035,104.861417,24.41317382,0
10.12.1.124,4224,10.1.1.2,502,5,320,5,320,0,0,312.183021,230.703308,11.09650322,0
10.12.1.124,3969,10.1.1.3,502,5,320,5,320,0,0,316.463109,125.841732,20.34301308,0
10.12.1.124,4736,10.1.1.2,502,5,320,5,320,0,0,319.173234,125.831723,20.34463122,0
10.12.1.124,4481,10.1.1.3,502,5,320,5,320,0,0,323.45309,34.950693,73.24604408,0
10.12.1.124,3584,10.1.1.2,502,5,320,5,320,0,0,326.163302,104.861478,24.41315962,0
10.12.1.124,3201,10.1.1.3,502,5,320,5,320,0,0,330.443341,104.862193,24.41299316,0
10.12.1.124,3968,10.1.1.2,502,5,320,5,320,0,0,333.153359,90.881214,28.1686378,0
10.12.1.124,3713,10.1.1.3,502,5,320,5,320,0,0,337.433314,125.841785,20.34300451,0
10.12.1.124,3712,10.1.1.2,502,1,64,1,64,0,0,340.143419,0,0,0
10.12.1.124,3712,10.1.1.2,502,5,320,5,320,0,0,340.143422,34.950392,73.24667489,0
10.12.1.124,3329,10.1.1.3,502,5,320,5,320,0,0,344.423501,125.841686,20.34302052,0
10.12.1.124,3328,10.1.1.2,502,5,320,5,320,0,0,347.133601,34.950444,73.24656591,0
10.12.1.124,4865,10.1.1.3,502,5,320,5,320,0,0,351.413537,125.841853,20.34299352,0
10.12.1.124,4864,10.1.1.2,502,5,320,5,320,0,0,354.123762,139.811927,18.31031197,0
10.12.1.124,4481,10.1.1.3,502,5,320,5,320,0,0,358.403787,125.841742,20.34301146,0
10.12.1.124,4480,10.1.1.2,502,5,320,5,320,0,0,361.113707,34.950543,73.24635843,0
10.12.1.124,4097,10.1.1.3,502,5,320,5,320,0,0,365.39456,90.890411,28.16578748,0
10.12.1.124,4096,10.1.1.2,502,5,320,5,320,0,0,368.103828,160.802333,15.92016703,0
10.12.1.124,3841,10.1.1.3,502,5,320,5,320,0,0,372.393895,34.950482,73.24648627,0
10.12.1.124,3712,10.1.1.2,502,5,320,5,320,0,0,375.093896,104.86154,24.41314518,0
10.12.1.124,3457,10.1.1.3,502,5,320,5,320,0,0,379.383955,139.811965,18.31030699,0
10.12.1.124,3328,10.1.1.2,502,5,320,5,320,0,0,382.084047,125.841701,20.34301809,0
10.12.1.124,3073,10.1.1.3,502,5,320,5,320,0,0,386.374215,34.950398,73.24666231,0
10.12.1.124,3840,10.1.1.2,502,5,320,5,320,0,0,389.074079,125.84179,20.3430037,0
10.12.1.124,4609,10.1.1.3,502,5,320,5,320,0,0,393.364159,160.803105,15.9200906,0
10.12.1.124,4480,10.1.1.2,502,5,320,5,320,0,0,396.064253,104.871501,24.41082635,0
10.12.1.124,4225,10.1.1.3,502,5,320,5,320,0,0,400.354226,104.861535,24.41314635,0
10.12.1.124,3072,10.1.1.2,502,5,320,5,320,0,0,403.054288,160.803008,15.9201002,0
10.12.1.124,3841,10.1.1.3,502,5,320,5,320,0,0,407.344379,125.841734,20.34301276,0
10.12.1.124,4608,10.1.1.2,502,5,320,5,320,0,0,410.045176,125.851127,20.34149444,0
10.12.1.124,4353,10.1.1.3,502,5,320,5,320,0,0,414.334455,34.960521,73.22545336,0
10.12.1.124,3456,10.1.1.2,502,5,320,5,320,0,0,417.04455,104.862237,24.41298291,0
10.12.1.124,3073,10.1.1.3,502,5,320,5,320,0,0,421.324617,104.862154,24.41300224,0
10.12.1.124,3968,10.1.1.2,502,5,320,5,320,0,0,424.034576,34.950632,73.24617191,0
10.12.1.124,3585,10.1.1.3,502,5,320,5,320,0,0,428.314731,181.822454,14.07966917,0
10.12.1.124,3584,10.1.1.2,502,5,320,5,320,0,0,431.024783,34.950548,73.24634795,0
10.12.1.124,3201,10.1.1.3,502,5,320,5,320,0,0,435.305537,146.842089,17.43369369,0
10.12.1.124,3200,10.1.1.2,502,5,320,5,320,0,0,438.014867,34.950486,73.24647789,0
10.12.1.124,3969,10.1.1.3,502,5,320,5,320,0,0,442.304844,104.862202,24.41299106,0
10.12.1.124,4736,10.1.1.2,502,5,320,5,320,0,0,445.004961,160.812283,15.91918199,0
10.12.1.124,4353,10.1.1.3,502,5,320,5,320,0,0,449.294979,125.861813,20.33976739,0
10.12.1.124,4352,10.1.1.2,502,5,320,5,320,0,0,451.995071,34.95057,73.24630185,0
10.12.1.124,4097,10.1.1.3,502,5,320,5,320,0,0,456.284981,34.950706,73.24601683,0
10.12.1.124,3968,10.1.1.2,502,5,320,5,320,0,0,458.985209,125.861665,20.33979131,0
10.12.1.124,3713,10.1.1.3,502,5,320,5,320,0,0,463.275101,34.950539,73.24636682,0
10.12.1.124,3584,10.1.1.2,502,5,320,5,320,0,0,465.975334,125.861566,20.33980731,0
10.12.1.124,3329,10.1.1.3,502,5,320,5,320,0,0,470.265216,181.822657,14.07965345,0
10.12.1.124,3200,10.1.1.2,502,5,320,5,320,0,0,472.965358,125.861716,20.33978307,0
10.12.1.124,4865,10.1.1.3,502,5,320,5,320,0,0,477.255391,34.950557,73.24632909,0
10.12.1.124,3712,10.1.1.2,502,5,320,5,320,0,0,479.955438,160.81228,15.91918229,0
10.12.1.124,4481,10.1.1.3,502,5,320,5,320,0,0,484.246037,251.733007,10.16950471,0
10.12.1.124,4352,10.1.1.2,502,5,320,5,320,0,0,486.945644,90.901879,28.16223414,0
10.12.1.124,4097,10.1.1.3,502,5,320,5,320,0,0,491.235689,146.871937,17.43015073,0
10.12.1.124,4864,10.1.1.2,502,5,320,5,320,0,0,493.935692,251.703385,10.17070152,0
10.12.1.124,3713,10.1.1.3,502,5,320,5,320,0,0,498.225643,307.704259,8.319676849,0
10.12.1.124,4480,10.1.1.2,502,5,320,5,320,0,0,500.935759,160.80212,15.92018812,0
10.12.1.124,4225,10.1.1.3,502,5,320,5,320,0,0,505.215762,34.96051,73.2254764,0
10.12.1.124,3328,10.1.1.2,502,5,320,5,320,0,0,507.92575,139.831999,18.30768364,0
10.12.1.124,4865,10.1.1.3,502,5,320,5,320,0,0,512.205951,272.743674,9.386102205,0
10.12.1.124,3840,10.1.1.2,502,5,320,5,320,0,0,514.915872,34.960593,73.22530256,0
10.12.1.124,3457,10.1.1.3,502,5,320,5,320,0,0,519.195921,146.882089,17.42894602,0
10.12.1.124,3456,10.1.1.2,502,5,320,5,320,0,0,521.906789,34.959725,73.22712064,0
10.12.1.124,3073,10.1.1.3,502,5,320,5,320,0,0,526.186772,181.831799,14.07894556,0
10.12.1.124,4096,10.1.1.2,502,5,320,5,320,0,0,528.906163,104.871371,24.41085661,0
10.12.1.124,3841,10.1.1.3,502,5,320,5,320,0,0,533.186117,125.892617,20.33479056,0
10.12.1.124,4608,10.1.1.2,502,5,320,5,320,0,0,535.896307,34.9605,73.22549735,0
10.12.1.124,4225,10.1.1.3,502,5,320,5,320,0,0,540.176275,20.99022,121.9615611,0
10.12.1.124,4224,10.1.1.2,502,5,320,5,320,0,0,542.886332,125.84179,20.3430037,0
10.12.1.124,3969,10.1.1.3,502,5,320,5,320,0,0,547.167049,55.970901,45.73805235,0
10.12.1.124,3840,10.1.1.2,502,5,320,5,320,0,0,549.876469,125.841806,20.34300112,0
10.12.1.124,4609,10.1.1.3,502,5,320,5,320,0,0,554.167266,90.930587,28.15334294,0
10.12.1.124,3456,10.1.1.2,502,5,320,5,320,0,0,556.866539,125.841727,20.34301389,0
10.12.1.124,4225,10.1.1.3,502,5,320,5,320,0,0,561.166497,125.881869,20.33652678,0
10.12.1.124,3072,10.1.1.2,502,5,320,5,320,0,0,563.857297,90.890722,28.1656911,0
10.12.1.124,4737,10.1.1.3,502,5,320,5,320,0,0,568.157434,20.989754,121.9642689,0
10.12.1.124,4608,10.1.1.2,502,5,320,5,320,0,0,570.856811,125.832356,20.34452887,0
10.12.1.124,4353,10.1.1.3,502,5,320,5,320,0,0,575.156797,20.990236,121.9614682,0
10.12.1.124,4352,10.1.1.2,502,5,320,5,320,0,0,577.847527,34.95982,73.22692165,0
10.12.1.124,3201,10.1.1.3,502,5,320,5,320,0,0,582.14763,34.979714,73.18527533,0
10.12.1.124,3968,10.1.1.2,502,5,320,5,320,0,0,584.846874,34.950483,73.24648418,0
10.12.1.124,4737,10.1.1.3,502,5,320,5,320,0,0,589.147526,34.970508,73.20454138,0
10.12.1.124,3584,10.1.1.2,502,5,320,5,320,0,0,591.836907,34.950563,73.24631652,0
10.12.1.124,4353,10.1.1.3,502,5,320,5,320,0,0,596.147035,34.970487,73.20458534,0
10.12.1.124,3200,10.1.1.2,502,4,256,4,256,0,0,598.827075,4.49983,455.1283048,0
10.12.1.124,3969,10.1.1.3,502,5,320,5,320,0,0,603.137955,125.850921,20.34152774,0
10.12.1.124,4736,10.1.1.2,502,4,256,4,256,0,0,605.817247,4.499361,455.1757461,0
10.12.1.124,3585,10.1.1.3,502,5,320,5,320,0,0,610.137196,160.823151,15.91810622,0
10.12.1.124,4352,10.1.1.2,502,5,320,5,320,0,0,612.807349,125.841688,20.34302019,0
10.12.1.124,3201,10.1.1.3,502,5,320,5,320,0,0,617.127347,125.84245,20.34289701,0
10.12.1.124,3968,10.1.1.2,502,5,320,5,320,0,0,619.797362,104.861588,24.41313401,0
10.12.1.124,4737,10.1.1.3,502,5,320,5,320,0,0,624.118037,90.890744,28.16568429,0
10.12.1.124,3584,10.1.1.2,502,5,320,5,320,0,0,626.787473,195.753482,13.07767287,0
10.12.1.124,4353,10.1.1.3,502,5,320,5,320,0,0,631.117531,90.881311,28.16860773,0
10.12.1.124,4096,10.1.1.2,502,5,320,5,320,0,0,633.777537,125.842021,20.34296636,0
10.12.1.124,4097,10.1.1.3,502,5,320,5,320,0,0,638.107627,34.960492,73.2255141,0
10.12.1.124,3712,10.1.1.2,502,5,320,5,320,0,0,640.767721,90.881982,28.16839976,0
10.12.1.124,4609,10.1.1.3,502,5,320,5,320,0,0,645.097855,34.960421,73.22566281,0
10.12.1.124,3328,10.1.1.2,502,5,320,5,320,0,0,647.757752,125.84183,20.34299724,0
10.12.1.124,3329,10.1.1.3,502,5,320,5,320,0,0,652.087876,125.871696,20.33817039,0
10.12.1.124,3072,10.1.1.2,502,5,320,5,320,0,0,654.748023,34.950275,73.24692009,0
10.12.1.124,3841,10.1.1.3,502,5,320,5,320,0,0,659.078737,34.959719,73.2271332,0
10.12.1.124,4480,10.1.1.2,502,5,320,5,320,0,0,661.737892,90.89135,28.1654965,0
10.12.1.124,3457,10.1.1.3,502,5,320,5,320,0,0,666.078014,34.950502,73.24644436,0
10.12.1.124,4224,10.1.1.2,502,5,320,5,320,0,0,668.728126,34.960492,73.2255141,0
10.12.1.124,4097,10.1.1.3,502,5,320,5,320,0,0,673.068121,90.901275,28.16242126,0
10.12.1.124,3840,10.1.1.2,502,5,320,5,320,0,0,675.718278,34.960409,73.22568795,0
10.12.1.124,4609,10.1.1.3,502,5,320,5,320,0,0,680.058278,160.82219,15.91820134,0
10.12.1.124,3456,10.1.1.2,502,5,320,5,320,0,0,682.70827,34.960487,73.22552458,0
10.12.1.124,4225,10.1.1.3,502,5,320,5,320,0,0,687.048368,146.842039,17.43369962,0
10.12.1.124,3072,10.1.1.2,502,5,320,5,320,0,0,689.698301,125.85189,20.34137111,0
10.12.1.124,3841,10.1.1.3,502,5,320,5,320,0,0,694.038459,181.81247,14.08044234,0
10.12.1.124,4608,10.1.1.2,502,5,320,5,320,0,0,696.68917,160.831615,15.9172685,0
10.12.1.124,3457,10.1.1.3,502,5,320,5,320,0,0,701.028519,125.87181,20.33815197,0
10.12.1.124,4224,10.1.1.2,502,5,320,5,320,0,0,703.68862,125.851682,20.34140473,0
10.12.1.124,3073,10.1.1.3,502,5,320,5,320,0,0,708.018729,146.851962,17.4325216,0
10.12.1.124,3840,10.1.1.2,502,5,320,5,320,0,0,710.678688,90.891295,28.16551354,0
10.12.1.124,4737,10.1.1.3,502,5,320,5,320,0,0,715.008785,34.96109,73.2242616,0
10.12.1.124,3456,10.1.1.2,502,5,320,5,320,0,0,717.66876,125.862509,20.33965492,0
10.12.1.124,4353,10.1.1.3,502,5,320,5,320,0,0,721.998843,34.97122,73.20305097,0
10.12.1.124,3968,10.1.1.2,502,5,320,5,320,0,0,724.658952,146.841946,17.43371066,0
10.12.1.124,3969,10.1.1.3,502,5,320,5,320,0,0,728.988877,160.842199,15.91622109,0
10.12.1.124,3712,10.1.1.2,502,5,320,5,320,0,0,731.649704,34.959728,73.22711435,0
10.12.1.124,4481,10.1.1.3,502,5,320,5,320,0,0,735.979057,55.96163,45.74562964,0
10.12.1.124,4352,10.1.1.2,502,5,320,5,320,0,0,738.64904,125.861831,20.33976448,0
10.12.1.124,3201,10.1.1.3,502,5,320,5,320,0,0,742.969799,125.881853,20.33652936,0
10.12.1.124,4864,10.1.1.2,502,5,320,5,320,0,0,745.63908,34.95054,73.24636472,0
10.12.1.124,4737,10.1.1.3,502,4,256,4,256,0,0,749.969889,4.508744,454.2284947,0
10.12.1.124,4480,10.1.1.2,502,5,320,5,320,0,0,752.629244,34.951162,73.24506121,0
10.12.1.124,4353,10.1.1.3,502,5,320,5,320,0,0,756.970065,90.901289,28.16241693,0
10.12.1.124,4096,10.1.1.2,502,5,320,5,320,0,0,759.619563,34.960219,73.22608591,0
10.12.1.124,4097,10.1.1.3,502,5,320,5,320,0,0,763.969399,34.970599,73.20435089,0
10.12.1.124,3712,10.1.1.2,502,5,320,5,320,0,0,766.609435,125.861753,20.33977709,0
10.12.1.124,3585,10.1.1.3,502,5,320,5,320,0,0,770.960351,90.900375,28.1627001,0
10.12.1.124,3328,10.1.1.2,502,5,320,5,320,0,0,773.599587,34.960449,73.22560417,0
10.12.1.124,3329,10.1.1.3,502,5,320,5,320,0,0,777.959573,34.960567,73.22535701,0
10.12.1.124,4864,10.1.1.2,502,4,256,4,256,0,0,780.589623,4.500503,455.0602455,0
10.12.1.124,4865,10.1.1.3,502,5,320,5,320,0,0,784.949627,34.960628,73.22522925,0
10.12.1.124,4480,10.1.1.2,502,4,256,4,256,0,0,787.580416,4.509095,454.1931363,0
10.12.1.124,4481,10.1.1.3,502,4,256,4,256,0,0,791.940689,4.508486,454.2544881,0
10.12.1.124,4096,10.1.1.2,502,5,320,5,320,0,0,794.579784,90.901311,28.16241011,0
10.12.1.124,4097,10.1.1.3,502,4,256,4,256,0,0,798.940002,4.49932,455.1798939,0
10.12.1.124,3840,10.1.1.2,502,5,320,5,320,0,0,801.569985,34.961104,73.22423228,0
10.12.1.124,3713,10.1.1.3,502,4,256,4,256,0,0,805.929904,4.499485,455.163202,0
10.12.1.124,3328,10.1.1.2,502,5,320,5,320,0,0,808.560036,90.901282,28.1624191,0
10.12.1.124,3329,10.1.1.3,502,4,256,4,256,0,0,812.920143,4.499363,455.1755437,0
10.12.1.124,3072,10.1.1.2,502,5,320,5,320,0,0,815.550193,34.98038,73.18388194,0
10.12.1.124,4865,10.1.1.3,502,4,256,4,256,0,0,819.910258,4.49945,455.1667426,0
10.12.1.124,3584,10.1.1.2,502,5,320,5,320,0,0,822.540958,55.950138,45.75502566,0
10.12.1.124,3457,10.1.1.3,502,4,256,4,256,0,0,826.900332,4.499388,455.1730146,0
10.12.1.124,4224,10.1.1.2,502,4,256,4,256,0,0,829.540305,4.499439,455.1678554,0
10.12.1.124,4225,10.1.1.3,502,4,256,4,256,0,0,833.890409,4.499439,455.1678554,0
10.12.1.124,3840,10.1.1.2,502,4,256,4,256,0,0,836.53109,4.508803,454.2225509,0
10.12.1.124,4609,10.1.1.3,502,4,256,4,256,0,0,840.880471,4.499447,455.1670461,0
10.12.1.124,3456,10.1.1.2,502,4,256,4,256,0,0,843.531272,4.508958,454.2069365,0
10.12.1.124,4353,10.1.1.3,502,5,320,5,320,0,0,847.871358,34.96963,73.20637936,0
10.12.1.124,3072,10.1.1.2,502,4,256,4,256,0,0,850.530574,4.499569,455.1547048,0
10.12.1.124,3073,10.1.1.3,502,4,256,4,256,0,0,854.870692,4.499357,455.1761507,0
10.12.1.124,4608,10.1.1.2,502,4,256,4,256,0,0,857.520788,4.499293,455.1826254,0
10.12.1.124,3585,10.1.1.3,502,5,320,5,320,0,0,861.860726,34.960485,73.22552876,0
10.12.1.124,4352,10.1.1.2,502,4,256,4,256,0,0,864.510874,4.499688,455.1426677,0
10.12.1.124,3201,10.1.1.3,502,4,256,4,256,0,0,868.851656,4.50904,454.1986764,0
10.12.1.124,3968,10.1.1.2,502,4,256,4,256,0,0,871.500901,4.4995,455.1616846,0
10.12.1.124,3841,10.1.1.3,502,4,256,4,256,0,0,875.850932,4.499804,455.1309346,0
10.12.1.124,3584,10.1.1.2,502,4,256,4,256,0,0,878.491099,4.499381,455.1737228,0
10.12.1.124,4353,10.1.1.3,502,4,256,4,256,0,0,882.840989,4.499565,455.1551094,0
10.12.1.124,4096,10.1.1.2,502,4,256,4,256,0,0,885.481098,4.499472,455.1645171,0
10.12.1.124,3969,10.1.1.3,502,4,256,4,256,0,0,889.831077,4.499547,455.1569302,0
10.12.1.124,3712,10.1.1.2,502,4,256,4,256,0,0,892.471189,4.499486,455.1631009,0
10.12.1.124,3585,10.1.1.3,502,4,256,4,256,0,0,896.821213,4.499405,455.1712949,0
10.12.1.124,3328,10.1.1.2,502,3,192,3,192,0,0,899.461321,2.999439,512.0957619,0
10.12.129.252,1430,10.12.128.180,443,1,60,1,60,0,0,559.01169,0,0,0
10.12.129.252,1447,10.12.128.179,80,1,60,1,60,0,0,559.856196,0,0,0
10.12.129.252,1567,10.12.128.40,80,3,317,3,317,0,0,559.992234,0.001105,0,0
10.12.129.252,1568,10.12.128.60,80,3,317,3,317,0,0,559.99241,0.00452,0,0
10.20.97.12,49447,10.12.0.241,445,40,4294,21,2142,19,2152,23.55564,788.795866,21.72425179,21.82567219
10.20.97.12,49449,10.12.0.223,445,6912,8710375,1019,91429,5893,8618946,23.696599,834.297024,876.7045536,82646.30703
10.20.97.12,63372,10.12.0.145,445,14,882,7,462,7,420,97.537387,720.101097,5.13261265,4.6660115
10.20.97.12,63339,10.12.0.143,445,14,882,7,462,7,420,99.041993,720.138041,5.132349341,4.665772128
10.20.97.12,63457,10.12.0.144,445,14,882,7,462,7,420,102.872748,720.071493,5.132823665,4.666203332
10.20.97.12,49564,10.12.0.121,3389,15,2591,9,1132,6,1459,121.156404,3.008305,3010.333061,3879.925739
10.20.97.12,49569,10.12.0.121,3389,479,239586,189,57569,290,182017,129.222463,10.668838,43167.96262,136484.9668
10.20.97.12,49575,10.12.0.121,3389,13,2471,7,1012,6,1459,154.450204,0.086271,93843.81774,135294.5949
10.20.97.12,49576,10.12.0.121,3389,994,543957,361,77897,633,466060,157.334296,15.098413,41274.27167,246945.1591
10.20.97.17,52738,10.12.0.63,445,18731,19123217,4322,465215,14409,18658002,5.481661,815.992034,4560.975898,182923.374
10.20.97.17,52983,10.12.0.61,445,11411,11884209,7590,9205337,3821,2678872,678.577013,76.898053,957666.5875,278693.35
10.20.97.17,52995,10.12.0.62,445,10400,11478429,7430,9466530,2970,2011899,740.292157,153.231464,494234.2651,105038.4274
10.20.97.87,61045,10.12.0.73,3389,6,390,4,259,2,131,637.828693,0.077609,26697.93452,13503.5885
10.20.97.87,61046,10.12.0.73,3389,16082,8778122,6204,815567,9878,7962555,638.854499,264.015302,24712.71911,241275.5606
10.21.97.35,50208,10.12.0.241,445,36,4994,20,2761,16,2233,653.818452,135.674185,162.8017887,131.6683789
10.21.97.35,50209,10.12.1.194,445,31,4989,18,2836,13,2153,656.118351,127.181011,178.391411,135.4290225
192.168.100.2,59835,111.221.77.162,80,2,128,2,128,0,0,0.272328,5.99869,170.703937,0
192.168.100.2,59836,157.56.52.20,443,2,128,2,128,0,0,0.711093,6.03173,169.7688723,0
192.168.100.2,59838,157.56.52.13,80,2,128,2,128,0,0,1.311265,6.001858,170.6138332,0
192.168.100.2,59842,157.55.235.176,80,3,194,3,194,0,0,1.37243,9.000672,172.4315696,0
192.168.100.2,59839,157.56.52.20,80,2,128,2,128,0,0,2.320933,6.032036,169.7602601,0
192.168.100.2,59840,157.55.235.176,443,2,128,2,128,0,0,2.762001,6.001028,170.6374308,0
192.168.100.2,59843,157.55.56.156,443,3,194,3,194,0,0,2.821559,9.001577,172.4142336,0
192.168.100.2,59846,157.55.56.156,80,3,194,3,194,0,0,4.43272,9.000406,172.4366656,0
192.168.100.2,59832,111.221.77.162,443,1,62,1,62,0,0,4.662145,0,0,0
192.168.100.2,59847,157.55.130.169,443,3,194,3,194,0,0,4.852451,8.999669,172.4507868,0
192.168.100.2,59834,157.56.52.13,443,1,62,1,62,0,0,5.701909,0,0,0
192.168.100.2,59848,111.221.77.145,443,3,194,3,194,0,0,5.862824,9.000233,172.4399802,0
192.168.100.2,59849,157.55.130.169,80,3,194,3,194,0,0,6.472528,9.000497,172.4349222,0
192.168.100.2,59850,111.221.77.145,80,3,194,3,194,0,0,7.473426,8.999618,172.4517641,0
192.168.100.2,59851,103.43.75.140,443,3,194,3,194,0,0,13.444213,9.02922,171.8863866,0
192.168.100.2,59853,103.43.75.140,80,3,194,3,194,0,0,15.444246,8.99962,172.4517257,0
192.168.100.2,59854,91.190.218.52,443,3,194,3,194,0,0,16.313528,9.000554,172.4338302,0
192.168.100.2,59855,91.190.218.52,80,3,194,3,194,0,0,17.933403,8.999611,172.4518982,0
192.168.100.2,59858,157.55.56.161,443,3,194,3,194,0,0,20.144504,8.999438,172.4552133,0
192.168.100.2,59860,157.55.235.153,443,3,194,3,194,0,0,21.194322,8.969778,173.025464,0
192.168.100.2,59861,157.55.56.161,80,3,194,3,194,0,0,21.764155,8.997872,172.4852276,0
192.168.100.2,59862,157.55.56.146,443,3,194,3,194,0,0,22.19437,9.002182,172.4026464,0
192.168.100.2,59864,157.55.235.153,80,3,194,3,194,0,0,22.784393,8.989528,172.6453269,0
192.168.100.2,59865,157.55.56.146,80,3,194,3,194,0,0,23.814365,9.000477,172.4353054,0
192.168.100.2,59866,157.56.52.48,443,3,194,3,194,0,0,24.234453,9.000563,172.4336578,0
192.168.100.2,59868,157.56.52.48,80,3,194,3,194,0,0,25.854197,9.000787,172.4293665,0
192.168.100.2,59869,65.55.223.34,443,3,194,3,194,0,0,27.305568,9.02925,171.8858155,0
192.168.100.2,59872,65.55.223.34,80,3,194,3,194,0,0,28.954306,8.980665,172.8157102,0
192.168.100.2,59873,157.55.56.159,443,3,194,3,194,0,0,29.349673,8.995135,172.5377107,0
192.168.100.2,59874,78.46.49.23,443,3,194,3,194,0,0,29.445087,9.009841,172.256092,0
192.168.100.2,59875,157.55.56.141,443,3,194,3,194,0,0,30.423879,8.97119,172.998231,0
192.168.100.2,59876,157.55.56.159,80,3,194,3,194,0,0,30.955349,9.009645,172.2598393,0
192.168.100.2,59877,78.46.49.23,80,3,194,3,194,0,0,31.446209,9.008581,172.2801849,0
192.168.100.2,59878,157.55.56.141,80,3,194,3,194,0,0,32.005329,9.009603,172.2606423,0
192.168.100.2,59881,157.56.52.17,443,3,194,3,194,0,0,44.586475,9.00041,172.436589,0
192.168.100.2,59883,85.25.103.30,443,3,194,3,194,0,0,45.467344,8.999495,172.454121,0
192.168.100.2,59884,157.56.52.22,443,3,194,3,194,0,0,45.597025,8.999921,172.4459581,0
192.168.100.2,59885,157.56.52.17,80,3,194,3,194,0,0,46.206206,9.000482,172.4352096,0
192.168.100.2,59886,64.4.23.153,443,3,194,3,194,0,0,46.62631,9.000559,172.4337344,0
192.168.100.2,59888,157.56.52.22,80,3,194,3,194,0,0,47.245843,8.971043,173.0010658,0
192.168.100.2,59889,85.25.103.30,80,3,194,3,194,0,0,47.485715,8.99113,172.6145657,0
192.168.100.2,59890,64.4.23.153,80,3,194,3,194,0,0,48.246347,9.029807,171.8752128,0
192.168.100.2,59891,157.55.130.168,443,3,194,3,194,0,0,48.667393,8.99952,172.453642,0
192.168.100.2,59893,157.55.130.168,80,3,194,3,194,0,0,50.287226,8.999582,172.4524539,0
192.168.100.2,59894,65.55.223.39,443,3,194,3,194,0,0,51.697339,9.000475,172.4353437,0
192.168.100.2,59897,65.55.223.39,80,3,194,3,194,0,0,53.317004,9.00085,172.4281596,0
192.168.100.2,59898,157.56.52.19,443,3,194,3,194,0,0,53.72702,9.030616,171.8598155,0
192.168.100.2,59899,157.56.52.23,443,3,194,3,194,0,0,54.777413,9.000325,172.4382175,0
192.168.100.2,59900,157.56.52.19,80,3,194,3,194,0,0,55.349489,8.998321,172.4766209,0
192.168.100.2,59901,157.56.52.23,80,3,194,3,194,0,0,56.397214,9.000464,172.4355544,0
192.168.100.2,59904,64.4.23.156,443,3,194,3,194,0,0,68.879335,9.029055,171.8895278,0
192.168.100.2,59906,157.56.52.26,443,3,194,3,194,0,0,69.889161,9.000552,172.4338685,0
192.168.100.2,59907,64.4.23.156,80,3,194,3,194,0,0,70.499276,8.999423,172.4555008,0
192.168.100.2,59908,64.4.23.160,443,3,194,3,194,0,0,70.919089,9.00071,172.4308416,0
192.168.100.2,59910,157.56.52.26,80,3,194,3,194,0,0,71.50917,9.000595,172.4330447,0
192.168.100.2,59911,64.4.23.160,80,3,194,3,194,0,0,72.539314,9.010257,172.248139,0
192.168.100.2,59913,157.55.130.149,443,3,194,3,194,0,0,73.009309,9.000445,172.4359184,0
192.168.100.2,59914,91.190.218.57,443,3,194,3,194,0,0,74.3195,9.029374,171.883455,0
192.168.100.2,59916,157.55.130.149,80,3,194,3,194,0,0,74.629172,9.000485,172.4351521,0
192.168.100.2,59917,91.190.218.57,80,3,194,3,194,0,0,75.939065,9.000617,172.4326232,0
192.168.100.2,59918,111.221.77.171,443,3,194,3,194,0,0,76.089109,9.000719,172.4306691,0
192.168.100.2,59921,111.221.77.171,80,3,194,3,194,0,0,77.709245,9.000576,172.4334087,0
192.168.100.2,59922,157.55.56.174,443,3,194,3,194,0,0,78.119206,9.000534,172.4342133,0
192.168.100.2,59923,111.221.77.140,443,3,194,3,194,0,0,79.16992,8.999816,172.44797,0
192.168.100.2,59924,157.55.56.174,80,3,194,3,194,0,0,79.730036,8.999613,172.4518599,0
192.168.100.2,59925,111.221.77.140,80,3,194,3,194,0,0,80.790167,8.999601,172.4520898,0
192.168.100.2,59928,157.55.235.162,443,3,194,3,194,0,0,93.321201,9.000471,172.4354203,0
192.168.100.2,59930,65.55.223.18,443,3,194,3,194,0,0,94.331364,9.000275,172.4391755,0
192.168.100.2,59931,157.55.235.162,80,3,194,3,194,0,0,94.941092,9.000557,172.4337727,0
192.168.100.2,59932,157.56.52.44,443,3,194,3,194,0,0,95.371004,9.000584,172.4332554,0
192.168.100.2,59934,65.55.223.18,80,3,194,3,194,0,0,95.951113,9.000415,172.4364932,0
192.168.100.2,59935,157.56.52.44,80,3,194,3,194,0,0,97.010703,8.971029,173.0013357,0
192.168.100.2,59936,64.4.23.149,443,3,194,3,194,0,0,97.450884,9.000829,172.4285619,0
192.168.100.2,59938,64.4.23.149,80,3,194,3,194,0,0,99.062089,8.999442,172.4551367,0
192.168.100.2,59939,64.4.23.169,443,3,194,3,194,0,0,100.481653,8.999873,172.4468779,0
192.168.100.2,59942,64.4.23.169,80,3,194,3,194,0,0,102.091919,9.000813,172.4288684,0
192.168.100.2,59943,157.55.56.162,443,3,194,3,194,0,0,102.502168,9.000393,172.4369147,0
192.168.100.2,59944,157.55.235.173,443,3,194,3,194,0,0,103.512019,9.000579,172.4333512,0
192.168.100.2,59945,157.55.56.162,80,3,194,3,194,0,0,104.111958,9.000629,172.4323933,0
192.168.100.2,59946,157.55.235.173,80,3,194,3,194,0,0,105.121936,9.000788,172.4293473,0
192.168.100.2,59949,157.55.235.167,443,3,194,3,194,0,0,117.712933,9.031204,171.8486262,0
192.168.100.2,59951,157.55.56.145,443,3,194,3,194,0,0,118.722975,9.001561,172.4145401,0
192.168.100.2,59952,103.43.75.140,443,3,194,3,194,0,0,118.803809,9.000736,172.4303435,0
192.168.100.2,59953,157.55.235.167,80,3,194,3,194,0,0,119.323106,9.001494,172.4158234,0
192.168.100.2,59954,64.4.23.140,443,3,194,3,194,0,0,119.762102,9.000012,172.4442145,0
192.168.100.2,59956,157.55.56.145,80,3,194,3,194,0,0,120.333144,9.001342,172.4187349,0
192.168.100.2,59957,103.43.75.140,80,3,194,3,194,0,0,120.803751,9.001175,172.4219338,0
192.168.100.2,59958,64.4.23.140,80,3,194,3,194,0,0,121.362879,9.001646,172.412912,0
192.168.100.2,59959,157.55.235.165,443,3,194,3,194,0,0,121.823934,9.000554,172.4338302,0
192.168.100.2,59961,157.55.235.165,80,3,194,3,194,0,0,123.433792,9.00173,172.4113032,0
192.168.100.2,59963,64.4.23.146,443,3,194,3,194,0,0,124.863923,8.991567,172.6061764,0
192.168.100.2,59966,91.190.218.64,443,3,194,3,194,0,0,126.324762,8.990622,172.624319,0
192.168.100.2,59967,64.4.23.146,80,3,194,3,194,0,0,126.474826,8.990623,172.6242998,0
192.168.100.2,59968,64.4.23.161,443,3,194,3,194,0,0,126.874852,8.9907,172.6228214,0
192.168.100.2,59969,111.221.77.148,443,3,194,3,194,0,0,127.894995,8.991475,172.6079425,0
192.168.100.2,59970,91.190.218.64,80,3,194,3,194,0,0,127.934947,8.9914,172.6093823,0
192.168.100.2,59971,64.4.23.161,80,3,194,3,194,0,0,128.485034,9.020743,172.0479122,0
192.168.100.2,59972,111.221.77.148,80,3,194,3,194,0,0,129.51487,8.991658,172.6044296,0
192.168.100.2,59973,78.46.49.23,443,3,194,3,194,0,0,134.806611,8.999817,172.4479509,0
192.168.100.2,59974,78.46.49.23,80,3,194,3,194,0,0,136.807467,8.998874,172.4660219,0
192.168.100.2,59977,111.221.77.156,443,3,194,3,194,0,0,142.086847,9.000503,172.4348073,0
192.168.100.2,59979,157.55.130.151,443,3,194,3,194,0,0,143.096854,9.000493,172.4349988,0
192.168.100.2,59980,111.221.77.156,80,3,194,3,194,0,0,143.7066,9.00069,172.4312247,0
192.168.100.2,59981,157.55.235.142,443,3,194,3,194,0,0,144.126918,9.000552,172.4338685,0
192.168.100.2,59983,157.55.130.151,80,3,194,3,194,0,0,144.716844,9.00053,172.43429,0
192.168.100.2,59984,157.55.235.142,80,3,194,3,194,0,0,145.749689,8.999807,172.4481425,0
192.168.100.2,59985,157.56.52.46,443,3,194,3,194,0,0,146.206851,9.001507,172.4155744,0
192.168.100.2,59987,157.56.52.46,80,3,194,3,194,0,0,147.81775,9.000556,172.4337919,0
192.168.100.2,59988,64.4.23.141,443,3,194,3,194,0,0,149.287755,8.999454,172.4549067,0
192.168.100.2,59991,85.25.103.30,443,3,194,3,194,0,0,150.808585,8.999949,172.4454216,0
192.168.100.2,59992,64.4.23.141,80,3,194,3,194,0,0,150.907741,9.000564,172.4336386,0
192.168.100.2,59993,157.55.56.147,443,3,194,3,194,0,0,151.349685,8.99859,172.471465,0
192.168.100.2,59994,157.55.130.143,443,3,194,3,194,0,0,152.377774,9.000587,172.433198,0
192.168.100.2,59995,85.25.103.30,80,3,194,3,194,0,0,152.807356,8.999973,172.4449618,0
192.168.100.2,59996,157.55.56.147,80,3,194,3,194,0,0,152.967866,9.000537,172.4341559,0
192.168.100.2,59997,157.55.130.143,80,3,194,3,194,0,0,153.997681,8.999563,172.452818,0
192.168.100.2,60000,157.56.52.18,443,3,194,3,194,0,0,166.528887,9.001368,172.4182369,0
192.168.100.2,60002,157.55.56.167,443,3,194,3,194,0,0,167.559212,8.97113,172.999388,0
192.168.100.2,60003,157.56.52.18,80,3,194,3,194,0,0,168.139771,9.030328,171.8652966,0
192.168.100.2,60004,65.55.223.25,443,3,194,3,194,0,0,168.569915,9.000368,172.4373937,0
192.168.100.2,60006,157.55.56.167,80,3,194,3,194,0,0,169.149701,9.000492,172.435018,0
192.168.100.2,60007,65.55.223.25,80,3,194,3,194,0,0,170.189704,9.000526,172.4343666,0
192.168.100.2,60008,157.56.52.43,443,3,194,3,194,0,0,170.639641,9.000726,172.430535,0
192.168.100.2,60010,157.56.52.43,80,3,194,3,194,0,0,172.259619,9.000706,172.4309182,0
192.168.100.2,60011,65.55.223.24,443,3,194,3,194,0,0,173.729629,9.000524,172.4344049,0
192.168.100.2,60014,65.55.223.24,80,3,194,3,194,0,0,175.349565,8.99069,172.6230134,0
192.168.100.2,60015,157.56.52.40,443,3,194,3,194,0,0,175.782852,8.998456,172.4740333,0
192.168.100.2,60016,157.55.235.152,443,3,194,3,194,0,0,176.820835,9.000204,172.4405358,0
192.168.100.2,60017,157.56.52.40,80,3,194,3,194,0,0,177.40059,9.000775,172.4295963,0
192.168.100.2,60018,157.55.235.152,80,3,194,3,194,0,0,178.440749,9.030472,171.862556,0
192.168.100.2,60020,91.190.218.58,443,3,194,3,194,0,0,184.380555,9.000651,172.4319719,0
192.168.100.2,60021,91.190.218.58,80,3,194,3,194,0,0,186.021519,8.969703,173.0269107,0
192.168.100.2,60024,157.55.235.158,443,3,194,3,194,0,0,191.111602,9.001589,172.4140038,0
192.168.100.2,60026,157.55.235.146,443,3,194,3,194,0,0,192.121467,9.00158,172.4141762,0
192.168.100.2,60027,157.55.235.158,80,3,194,3,194,0,0,192.731616,9.001434,172.4169727,0
192.168.100.2,60028,65.55.223.35,443,3,194,3,194,0,0,193.161462,9.001609,172.4136207,0
192.168.100.2,60030,157.55.235.146,80,3,194,3,194,0,0,193.749747,8.999955,172.4453067,0
192.168.100.2,60031,65.55.223.35,80,3,194,3,194,0,0,194.78188,9.001243,172.4206312,0
192.168.100.2,60032,157.55.56.153,443,3,194,3,194,0,0,195.23161,9.001568,172.414406,0
192.168.100.2,60034,157.55.56.153,80,3,194,3,194,0,0,196.842695,9.000539,172.4341176,0
192.168.100.2,60035,65.55.223.32,443,3,194,3,194,0,0,198.312265,9.00075,172.4300753,0
192.168.100.2,60038,65.55.223.32,80,3,194,3,194,0,0,199.923661,9.000378,172.4372021,0
192.168.100.2,60039,65.55.223.46,443,3,194,3,194,0,0,200.373663,9.0003,172.4386965,0
192.168.100.2,60040,157.55.130.176,443,3,194,3,194,0,0,201.413547,9.000505,172.4347689,0
192.168.100.2,60041,65.55.223.46,80,3,194,3,194,0,0,201.993614,9.000412,172.4365507,0
192.168.100.2,60042,157.55.130.176,80,3,194,3,194,0,0,203.033566,9.000394,172.4368955,0
192.168.100.2,60045,65.55.223.28,443,3,194,3,194,0,0,215.654621,9.000327,172.4381792,0
192.168.100.2,60047,157.56.52.18,443,3,194,3,194,0,0,216.664448,9.000589,172.4331597,0
192.168.100.2,60048,65.55.223.28,80,3,194,3,194,0,0,217.274566,9.000414,172.4365124,0
192.168.100.2,60049,65.55.223.12,443,3,194,3,194,0,0,217.724293,8.970747,173.0067741,0
192.168.100.2,60051,157.56.52.18,80,3,194,3,194,0,0,218.284466,9.000585,172.4332363,0
192.168.100.2,60052,103.43.75.140,443,3,194,3,194,0,0,218.761142,9.000991,172.4254585,0
192.168.100.2,60053,65.55.223.12,80,3,194,3,194,0,0,219.314529,9.000354,172.4376619,0
192.168.100.2,60054,157.55.56.169,443,3,194,3,194,0,0,219.764437,9.00055,172.4339068,0
192.168.100.2,60055,103.43.75.140,80,3,194,3,194,0,0,220.761138,9.001122,172.4229491,0
192.168.100.2,60057,157.55.56.169,80,3,194,3,194,0,0,221.375541,8.990414,172.6283128,0
192.168.100.2,60058,157.55.235.141,443,3,194,3,194,0,0,222.845658,9.000316,172.4383899,0
192.168.100.2,60061,157.55.235.141,80,3,194,3,194,0,0,224.465458,9.000645,172.4320868,0
192.168.100.2,60062,157.55.235.140,443,3,194,3,194,0,0,224.865546,8.990361,172.6293305,0
192.168.100.2,60063,111.221.77.165,443,3,194,3,194,0,0,225.905369,9.00055,172.4339068,0
192.168.100.2,60064,157.55.235.140,80,3,194,3,194,0,0,226.485476,9.000348,172.4377769,0
192.168.100.2,60065,111.221.77.165,80,3,194,3,194,0,0,227.547905,8.957989,173.253171,0
192.168.100.2,60066,78.46.49.23,443,3,194,3,194,0,0,234.763111,8.999036,172.4629171,0
192.168.100.2,60068,78.46.49.23,80,3,194,3,194,0,0,236.761288,9.000915,172.4269144,0
192.168.100.2,60069,91.190.218.51,443,3,194,3,194,0,0,237.396324,9.00068,172.4314163,0
192.168.100.2,60071,91.190.218.51,80,3,194,3,194,0,0,239.00752,9.000334,172.4380451,0
192.168.100.2,60073,111.221.77.153,443,3,194,3,194,0,0,240.027357,9.030616,171.8598155,0
192.168.100.2,60075,157.56.52.14,443,3,194,3,194,0,0,241.047229,9.000731,172.4304393,0
192.168.100.2,60076,111.221.77.153,80,3,194,3,194,0,0,241.63728,9.00039,172.4369722,0
192.168.100.2,60077,111.221.77.150,443,3,194,3,194,0,0,242.077447,9.000448,172.435861,0
192.168.100.2,60078,157.56.52.14,80,3,194,3,194,0,0,242.657316,9.002537,172.395848,0
192.168.100.2,60079,111.221.77.150,80,3,194,3,194,0,0,243.687424,9.030241,171.8669524,0
192.168.100.2,60080,85.25.103.30,443,3,194,3,194,0,0,250.761137,9.001175,172.4219338,0
192.168.100.2,60081,85.25.103.30,80,3,194,3,194,0,0,252.761093,9.001266,172.4201907,0
192.168.100.2,60083,91.190.218.59,443,3,194,3,194,0,0,289.413132,9.000572,172.4334853,0
192.168.100.2,60084,91.190.218.59,80,3,194,3,194,0,0,291.033044,9.000554,172.4338302,0
192.168.100.2,60085,103.43.75.140,443,3,194,3,194,0,0,312.504702,8.990814,172.6206326,0
192.168.100.2,60086,103.43.75.140,80,3,194,3,194,0,0,314.495852,9.009683,172.2591128,0
192.168.100.2,60087,78.46.49.23,443,3,194,3,194,0,0,328.527672,8.999718,172.4498479,0
192.168.100.2,60088,78.46.49.23,80,3,194,3,194,0,0,330.527785,8.999039,172.4628596,0
192.168.100.2,60090,111.221.77.146,443,3,194,3,194,0,0,334.477887,8.999534,172.4533737,0
192.168.100.2,60091,111.221.77.146,80,3,194,3,194,0,0,336.097907,9.000482,172.4352096,0
192.168.100.2,60092,85.25.103.30,443,3,194,3,194,0,0,344.538378,9.005608,172.3370593,0
192.168.100.2,60093,85.25.103.30,80,3,194,3,194,0,0,346.538579,9.011131,172.2314324,0
192.168.100.2,60096,157.55.130.174,443,3,194,3,194,0,0,349.478737,8.999699,172.4502119,0
192.168.100.2,60097,157.55.56.176,443,3,194,3,194,0,0,349.478739,8.999694,172.4503078,0
192.168.100.2,60098,157.55.130.174,80,3,194,3,194,0,0,351.088745,8.999477,172.454466,0
192.168.100.2,60099,157.55.56.176,80,3,194,3,194,0,0,351.088749,8.999475,172.4545043,0
192.168.100.2,60102,91.190.219.44,443,3,194,3,194,0,0,361.430596,8.999671,172.4507485,0
192.168.100.2,60103,157.56.52.21,443,3,194,3,194,0,0,361.639684,9.000707,172.430899,0
192.168.100.2,60104,91.190.219.44,80,3,194,3,194,0,0,363.03983,9.000505,172.4347689,0
192.168.100.2,60105,157.56.52.21,80,3,194,3,194,0,0,363.249862,9.000377,172.4372212,0
192.168.100.2,60108,64.4.23.170,443,3,194,3,194,0,0,375.711064,9.123292,170.1140334,0
192.168.100.2,60109,157.56.52.37,443,3,194,3,194,0,0,375.711067,9.123288,170.114108,0
192.168.100.2,60110,64.4.23.170,80,3,194,3,194,0,0,377.3308,8.999278,172.4582794,0
192.168.100.2,60111,157.56.52.37,80,3,194,3,194,0,0,377.330804,8.999277,172.4582986,0
192.168.100.2,60113,65.55.223.31,443,3,194,3,194,0,0,387.77174,9.000602,172.4329106,0
192.168.100.2,60114,65.55.223.31,80,3,194,3,194,0,0,389.391624,9.000389,172.4369913,0
192.168.100.2,60117,157.56.52.34,443,3,194,3,194,0,0,401.931892,8.970185,173.0176133,0
192.168.100.2,60118,157.56.52.25,443,3,194,3,194,0,0,401.931895,8.970178,173.0177484,0
192.168.100.2,60119,157.56.52.34,80,3,194,3,194,0,0,403.522966,8.999087,172.4619398,0
192.168.100.2,60120,157.56.52.25,80,3,194,3,194,0,0,403.522969,8.999087,172.4619398,0
192.168.100.2,60121,103.43.75.140,443,3,194,3,194,0,0,404.303255,8.99975,172.4492347,0
192.168.100.2,60122,103.43.75.140,80,3,194,3,194,0,0,406.302871,9.000145,172.4416662,0
192.168.100.2,60125,91.190.218.66,443,3,194,3,194,0,0,412.463302,9.000677,172.4314738,0
192.168.100.2,60126,111.221.77.176,443,3,194,3,194,0,0,414.043481,9.000422,172.4363591,0
192.168.100.2,60127,91.190.218.66,80,3,194,3,194,0,0,414.083365,9.000679,172.4314355,0
192.168.100.2,60128,111.221.77.176,80,3,194,3,194,0,0,415.663565,9.00038,172.4371638,0
192.168.100.2,60129,78.46.49.23,443,3,194,3,194,0,0,420.305211,8.998764,172.4681301,0
192.168.100.2,60130,78.46.49.23,80,3,194,3,194,0,0,422.333436,8.98044,172.82004,0
192.168.100.2,60133,157.55.56.156,443,3,194,3,194,0,0,428.224247,8.969536,173.0301322,0
192.168.100.2,60134,157.55.235.176,443,3,194,3,194,0,0,428.224249,8.969532,173.0302094,0
192.168.100.2,60135,157.55.56.156,80,3,194,3,194,0,0,429.814615,8.999268,172.4584711,0
192.168.100.2,60136,157.55.235.176,80,3,194,3,194,0,0,429.814616,8.999272,172.4583944,0
192.168.100.2,60137,85.25.103.30,443,3,194,3,194,0,0,436.377576,9.008304,172.2854824,0
192.168.100.2,60138,85.25.103.30,80,3,194,3,194,0,0,438.386417,9.009523,172.2621719,0
192.168.100.2,60140,65.55.223.14,443,3,194,3,194,0,0,440.235474,9.000501,172.4348456,0
192.168.100.2,60141,65.55.223.14,80,3,194,3,194,0,0,441.855353,9.00052,172.4344816,0
192.168.100.2,60144,111.221.77.145,443,3,194,3,194,0,0,454.187267,9.028449,171.9010652,0
192.168.100.2,60145,157.55.56.159,443,3,194,3,194,0,0,454.187271,9.028449,171.9010652,0
192.168.100.2,60146,111.221.77.145,80,3,194,3,194,0,0,455.807304,8.99844,172.47434,0
192.168.100.2,60147,157.55.56.159,80,3,194,3,194,0,0,455.807304,8.998441,172.4743208,0
192.168.100.2,60149,157.55.130.168,443,3,194,3,194,0,0,466.218162,9.000581,172.4333129,0
192.168.100.2,60151,157.55.130.168,80,3,194,3,194,0,0,467.837914,8.999717,172.449867,0
192.168.100.2,60152,91.190.218.52,443,3,194,3,194,0,0,468.498278,9.00056,172.4337152,0
192.168.100.2,60153,91.190.218.52,80,3,194,3,194,0,0,470.117917,9.000735,172.4303626,0
192.168.100.2,60156,157.55.235.162,443,3,194,3,194,0,0,480.429038,9.000429,172.436225,0
192.168.100.2,60157,157.55.130.149,443,3,194,3,194,0,0,480.429041,9.000425,172.4363016,0
192.168.100.2,60158,157.55.235.162,80,3,194,3,194,0,0,482.039128,8.999502,172.4539869,0
192.168.100.2,60159,157.55.130.149,80,3,194,3,194,0,0,482.039129,8.999497,172.4540827,0
192.168.100.2,60161,111.221.77.140,443,3,194,3,194,0,0,492.470072,9.000578,172.4333704,0
192.168.100.2,60162,111.221.77.140,80,3,194,3,194,0,0,494.080058,9.000607,172.4328148,0
192.168.100.2,60163,103.43.75.140,443,3,194,3,194,0,0,499.370753,8.970728,173.0071406,0
192.168.100.2,60164,103.43.75.140,80,3,194,3,194,0,0,501.340739,9.00098,172.4256692,0
192.168.100.2,60167,157.55.235.165,443,3,194,3,194,0,0,505.461015,8.999608,172.4519557,0
192.168.100.2,60168,157.56.52.18,443,3,194,3,194,0,0,505.461019,8.999607,172.4519748,0
192.168.100.2,60169,157.55.235.165,80,3,194,3,194,0,0,507.071049,8.9994,172.4559415,0
192.168.100.2,60170,157.56.52.18,80,3,194,3,194,0,0,507.071052,8.999396,172.4560182,0
192.168.100.2,60172,91.190.218.57,443,3,194,3,194,0,0,513.522047,9.00039,172.4369722,0
192.168.100.2,60173,91.190.218.57,80,3,194,3,194,0,0,515.142093,9.008178,172.2878922,0
192.168.100.2,60174,78.46.49.23,443,3,194,3,194,0,0,515.342802,8.999705,172.450097,0
192.168.100.2,60176,78.46.49.23,80,3,194,3,194,0,0,517.34157,9.001052,172.42429,0
192.168.100.2,60177,64.4.23.141,443,3,194,3,194,0,0,517.641348,8.971087,173.0002173,0
192.168.100.2,60178,64.4.23.141,80,3,194,3,194,0,0,519.231799,9.030748,171.8573035,0
192.168.100.2,60181,65.55.223.35,443,3,194,3,194,0,0,529.692935,8.999326,172.4573596,0
192.168.100.2,60182,65.55.223.46,443,3,194,3,194,0,0,529.692937,8.999325,172.4573787,0
192.168.100.2,60183,65.55.223.35,80,3,194,3,194,0,0,531.312843,9.000553,172.4338493,0
192.168.100.2,60184,65.55.223.46,80,3,194,3,194,0,0,531.312847,9.000554,172.4338302,0
192.168.100.2,60185,85.25.103.30,443,3,194,3,194,0,0,531.343743,9.000653,172.4319335,0
192.168.100.2,60186,85.25.103.30,80,3,194,3,194,0,0,533.344639,8.99985,172.4473186,0
192.168.100.2,60188,157.56.52.18,443,3,194,3,194,0,0,543.704767,8.99965,172.4511509,0
192.168.100.2,60189,157.56.52.18,80,3,194,3,194,0,0,545.324833,9.000481,172.4352287,0
192.168.100.2,60192,65.55.223.28,443,3,194,3,194,0,0,555.735766,8.998432,172.4744933,0
192.168.100.2,60193,157.55.56.154,443,3,194,3,194,0,0,555.735956,8.998241,172.4781543,0
192.168.100.2,60194,65.55.223.28,80,3,194,3,194,0,0,557.355845,8.999384,172.4562481,0
192.168.100.2,60195,157.55.56.154,80,3,194,3,194,0,0,557.355846,8.999384,172.4562481,0
192.168.100.2,60198,91.190.218.64,443,3,194,3,194,0,0,568.537786,8.999491,172.4541977,0
192.168.100.2,60199,157.55.235.170,443,3,194,3,194,0,0,568.77769,8.999432,172.4553283,0
192.168.100.2,60200,91.190.218.64,80,3,194,3,194,0,0,570.161303,8.995864,172.5237287,0
192.168.100.2,60201,157.55.235.170,80,3,194,3,194,0,0,570.397766,9.000385,172.437068,0
192.168.100.2,60204,111.221.77.159,443,3,194,3,194,0,0,580.968682,9.000429,172.436225,0
192.168.100.2,60205,157.55.235.160,443,3,194,3,194,0,0,582.01864,9.00048,172.4352479,0
192.168.100.2,60206,111.221.77.159,80,3,194,3,194,0,0,582.588524,9.00066,172.4317994,0
192.168.100.2,60207,157.55.235.160,80,3,194,3,194,0,0,583.638537,9.000608,172.4327957,0
192.168.100.2,60209,65.55.223.44,443,3,194,3,194,0,0,593.119589,9.000639,172.4322018,0
192.168.100.2,60210,65.55.223.44,80,3,194,3,194,0,0,594.750156,8.999808,172.4481233,0
192.168.100.2,60211,103.43.75.140,443,3,194,3,194,0,0,602.501133,8.999948,172.4454408,0
192.168.100.2,60213,103.43.75.140,80,3,194,3,194,0,0,604.511407,8.999629,172.4515533,0
192.168.100.2,60215,111.221.77.151,443,3,194,3,194,0,0,605.260608,9.000381,172.4371446,0
192.168.100.2,60216,64.4.23.151,443,3,194,3,194,0,0,606.310543,9.000536,172.434175,0
192.168.100.2,60217,111.221.77.151,80,3,194,3,194,0,0,606.88044,9.000391,172.436953,0
192.168.100.2,60218,64.4.23.151,80,3,194,3,194,0,0,607.920559,9.000383,172.4371063,0
192.168.100.2,60220,157.55.130.170,443,3,194,3,194,0,0,617.411348,9.00056,172.4337152,0
192.168.100.2,60222,78.46.49.23,443,3,194,3,194,0,0,618.51214,9.02917,171.8873385,0
192.168.100.2,60223,157.55.130.170,80,3,194,3,194,0,0,619.021407,9.000555,172.433811,0
192.168.100.2,60224,91.190.218.58,443,3,194,3,194,0,0,619.591338,9.010328,172.2467817,0
192.168.100.2,60225,78.46.49.23,80,3,194,3,194,0,0,620.511996,8.999722,172.4497712,0
192.168.100.2,60226,91.190.218.58,80,3,194,3,194,0,0,621.201392,9.000565,172.4336194,0
192.168.100.2,60229,157.55.56.146,443,3,194,3,194,0,0,629.602488,9.000261,172.4394437,0
192.168.100.2,60230,157.55.235.151,443,3,194,3,194,0,0,630.642324,9.0005,172.4348647,0
192.168.100.2,60231,157.55.56.146,80,3,194,3,194,0,0,631.212382,9.000465,172.4355353,0
192.168.100.2,60232,157.55.235.151,80,3,194,3,194,0,0,632.252321,9.000561,172.4336961,0
192.168.100.2,60233,85.25.103.30,443,3,194,3,194,0,0,634.514034,8.998877,172.4659644,0
192.168.100.2,60234,85.25.103.30,80,3,194,3,194,0,0,636.514103,9.027939,171.9107761,0
192.168.100.2,60236,157.55.235.164,443,3,194,3,194,0,0,641.749886,9.00017,172.4411872,0
192.168.100.2,60237,157.55.235.164,80,3,194,3,194,0,0,643.363615,9.000174,172.4411106,0
192.168.100.2,60240,157.55.235.168,443,3,194,3,194,0,0,654.034272,9.00056,172.4337152,0
192.168.100.2,60241,157.55.130.172,443,3,194,3,194,0,0,655.074105,9.001733,172.4112457,0
192.168.100.2,60242,157.55.235.168,80,3,194,3,194,0,0,655.654171,9.001595,172.4138889,0
192.168.100.2,60243,157.55.130.172,80,3,194,3,194,0,0,656.694828,9.001023,172.4248455,0
192.168.100.2,60246,157.55.56.149,443,3,194,3,194,0,0,666.286192,9.000499,172.4348839,0
192.168.100.2,60247,91.190.218.51,443,3,194,3,194,0,0,667.596117,9.00063,172.4323742,0
192.168.100.2,60248,157.55.56.149,80,3,194,3,194,0,0,667.906152,9.000625,172.43247,0
192.168.100.2,60249,91.190.218.51,80,3,194,3,194,0,0,669.216061,9.0006,172.4329489,0
192.168.100.2,60252,157.55.56.146,443,3,194,3,194,0,0,678.477045,9.001552,172.4147125,0
192.168.100.2,60253,65.55.223.21,443,3,194,3,194,0,0,679.517172,9.001476,172.4161682,0
192.168.100.2,60254,157.55.56.146,80,3,194,3,194,0,0,680.09691,9.001674,172.4123757,0
192.168.100.2,60255,65.55.223.21,80,3,194,3,194,0,0,681.128074,9.000377,172.4372212,0
192.168.100.2,60257,157.55.56.170,443,3,194,3,194,0,0,690.729027,9.000709,172.4308607,0
192.168.100.2,60258,157.55.56.170,80,3,194,3,194,0,0,692.349015,9.000481,172.4352287,0
192.168.100.2,60260,103.43.75.140,443,3,194,3,194,0,0,702.110843,8.999564,172.4527988,0
192.168.100.2,60262,65.55.223.19,443,3,194,3,194,0,0,702.820077,9.00036,172.4375469,0
192.168.100.2,60263,157.55.56.148,443,3,194,3,194,0,0,703.849942,9.000571,172.4335045,0
192.168.100.2,60264,103.43.75.140,80,3,194,3,194,0,0,704.120799,8.999796,172.4483533,0
192.168.100.2,60265,65.55.223.19,80,3,194,3,194,0,0,704.439969,9.000657,172.4318569,0
192.168.100.2,60266,157.55.56.148,80,3,194,3,194,0,0,705.460926,8.999622,172.4516874,0
192.168.100.2,60268,91.190.218.59,443,3,194,3,194,0,0,712.630927,9.000523,172.4344241,0
192.168.100.2,60270,91.190.218.59,80,3,194,3,194,0,0,714.252877,8.998629,172.4707175,0
192.168.100.2,60271,111.221.77.152,443,3,194,3,194,0,0,715.120783,9.000652,172.4319527,0
192.168.100.2,60272,111.221.77.152,80,3,194,3,194,0,0,716.762496,8.987548,172.6833615,0
192.168.100.2,60273,78.46.49.23,443,3,194,3,194,0,0,718.132685,8.998767,172.4680726,0
192.168.100.2,60274,78.46.49.23,80,3,194,3,194,0,0,720.132114,8.999299,172.457877,0
192.168.100.2,60277,111.221.77.141,443,3,194,3,194,0,0,727.261908,9.000438,172.4360526,0
192.168.100.2,60278,157.55.235.147,443,3,194,3,194,0,0,728.281856,9.000461,172.4356119,0
192.168.100.2,60279,111.221.77.141,80,3,194,3,194,0,0,728.87192,9.001391,172.4177963,0
192.168.100.2,60280,157.55.235.147,80,3,194,3,194,0,0,729.892381,9.030552,171.8610335,0
192.168.100.2,60281,85.25.103.30,443,3,194,3,194,0,0,734.133601,8.999785,172.448564,0
192.168.100.2,60282,85.25.103.30,80,3,194,3,194,0,0,736.162044,8.971188,172.9982696,0
192.168.100.2,60284,157.55.130.162,443,3,194,3,194,0,0,739.463898,8.999418,172.4555966,0
192.168.100.2,60285,157.55.130.162,80,3,194,3,194,0,0,741.073697,8.999611,172.4518982,0
192.168.100.2,60288,64.4.23.168,443,3,194,3,194,0,0,751.534742,8.999603,172.4520515,0
192.168.100.2,60289,157.55.130.140,443,3,194,3,194,0,0,752.564741,9.028903,171.8924215,0
192.168.100.2,60290,64.4.23.168,80,3,194,3,194,0,0,753.144673,9.005343,172.3421307,0
192.168.100.2,60291,157.55.130.140,80,3,194,3,194,0,0,754.174576,9.0007,172.4310331,0
192.168.100.2,60293,64.4.23.163,443,3,194,3,194,0,0,763.735707,8.999574,172.4526072,0
192.168.100.2,60294,64.4.23.163,80,3,194,3,194,0,0,765.355762,8.999407,172.4558074,0
192.168.100.2,60297,157.55.235.149,443,3,194,3,194,0,0,776.016643,8.999478,172.4544468,0
192.168.100.2,60298,157.55.130.173,443,3,194,3,194,0,0,777.046584,8.999479,172.4544276,0
192.168.100.2,60299,157.55.235.149,80,3,194,3,194,0,0,777.636594,8.999471,172.4545809,0
192.168.100.2,60300,157.55.130.173,80,3,194,3,194,0,0,778.666544,9.000416,172.436474,0
192.168.100.2,60302,91.190.219.44,443,3,194,3,194,0,0,784.696453,9.031411,171.8446874,0
192.168.100.2,60303,91.190.219.44,80,3,194,3,194,0,0,786.316599,8.991346,172.610419,0
192.168.100.2,60305,157.55.130.152,443,3,194,3,194,0,0,788.328192,8.999955,172.4453067,0
192.168.100.2,60306,157.55.130.152,80,3,194,3,194,0,0,789.938521,9.02926,171.8856252,0
192.168.100.2,60309,157.55.56.151,443,3,194,3,194,0,0,800.499459,8.999427,172.4554241,0
192.168.100.2,60310,157.55.130.171,443,3,194,3,194,0,0,801.539412,8.9995,172.4540252,0
192.168.100.2,60311,157.55.56.151,80,3,194,3,194,0,0,802.119481,8.999523,172.4535845,0
192.168.100.2,60312,157.55.130.171,80,3,194,3,194,0,0,803.159451,9.003059,172.3858524,0
192.168.100.2,60313,103.43.75.140,443,3,194,3,194,0,0,806.450431,8.999443,172.4551175,0
192.168.100.2,60314,103.43.75.140,80,3,194,3,194,0,0,808.46033,8.999559,172.4528946,0
192.168.100.2,60316,157.55.130.144,443,3,194,3,194,0,0,812.710471,8.999438,172.4552133,0
192.168.100.2,60317,157.55.130.144,80,3,194,3,194,0,0,814.330423,8.999346,172.4569763,0
192.168.100.2,60318,78.46.49.23,443,3,194,3,194,0,0,822.521424,8.999352,172.4568613,0
192.168.100.2,60321,78.46.49.23,80,3,194,3,194,0,0,824.540805,8.98001,172.8283153,0
192.168.100.2,60322,157.55.56.164,443,3,194,3,194,0,0,824.891329,8.999485,172.4543127,0
192.168.100.2,60323,157.55.130.148,443,3,194,3,194,0,0,825.931008,8.999805,172.4481808,0
192.168.100.2,60324,157.55.56.164,80,3,194,3,194,0,0,826.53021,8.981631,172.7971234,0
192.168.100.2,60325,157.55.130.148,80,3,194,3,194,0,0,827.541376,8.999467,172.4546576,0
192.168.100.2,60327,91.190.218.66,443,3,194,3,194,0,0,832.731285,9.000566,172.4336003,0
192.168.100.2,60328,91.190.218.66,80,3,194,3,194,0,0,834.351272,9.020037,172.0613785,0
192.168.100.2,60330,157.55.235.146,443,3,194,3,194,0,0,837.202246,8.998464,172.47388,0
192.168.100.2,60331,85.25.103.30,443,3,194,3,194,0,0,838.541912,9.000893,172.4273358,0
192.168.100.2,60332,157.55.235.146,80,3,194,3,194,0,0,838.822366,9.00034,172.4379301,0
192.168.100.2,60333,85.25.103.30,80,3,194,3,194,0,0,840.542047,9.000676,172.4314929,0
192.168.100.2,60336,157.55.56.152,443,3,194,3,194,0,0,849.432747,9.001989,172.4063426,0
192.168.100.2,60341,157.56.52.39,443,3,194,3,194,0,0,850.493104,9.000988,172.425516,0
192.168.100.2,60342,157.55.56.152,80,3,194,3,194,0,0,851.044251,9.001434,172.4169727,0
192.168.100.2,60343,65.55.223.22,443,3,194,3,194,0,0,851.48416,9.000618,172.4326041,0
192.168.100.2,60344,65.55.223.42,443,3,194,3,194,0,0,851.484161,9.000615,172.4326615,0
192.168.100.2,60345,111.221.77.164,443,3,194,3,194,0,0,851.484162,9.000609,172.4327765,0
192.168.100.2,60346,111.221.77.155,443,3,194,3,194,0,0,851.485195,8.999584,172.4524156,0
192.168.100.2,60347,157.56.52.39,80,3,194,3,194,0,0,852.074353,9.001476,172.4161682,0
192.168.100.2,60348,65.55.223.22,80,3,194,3,194,0,0,853.104358,9.030211,171.8675234,0
192.168.100.2,60349,65.55.223.42,80,3,194,3,194,0,0,853.104362,9.030214,171.8674663,0
192.168.100.2,60350,111.221.77.164,80,3,194,3,194,0,0,853.104363,9.030211,171.8675234,0
192.168.100.2,60351,111.221.77.155,80,3,194,3,194,0,0,853.105336,9.029239,171.8860249,0
192.168.100.2,60353,157.55.130.156,443,3,194,3,194,0,0,861.64631,8.991274,172.6118012,0
192.168.100.2,60354,157.55.130.156,80,3,194,3,194,0,0,863.257147,9.000476,172.4353245,0
192.168.100.2,60357,157.55.130.158,443,3,194,3,194,0,0,873.898874,8.999801,172.4482575,0
192.168.100.2,60362,65.55.223.13,443,3,194,3,194,0,0,874.929013,8.999603,172.4520515,0
192.168.100.2,60363,157.55.130.158,80,3,194,3,194,0,0,875.509153,8.999429,172.4553858,0
192.168.100.2,60364,64.4.23.174,443,3,194,3,194,0,0,875.969106,8.999471,172.4545809,0
192.168.100.2,60365,157.55.56.173,443,3,194,3,194,0,0,875.969111,8.999467,172.4546576,0
192.168.100.2,60366,157.56.52.35,443,3,194,3,194,0,0,875.969112,8.99946,172.4547917,0
192.168.100.2,60367,111.221.77.170,443,3,194,3,194,0,0,875.970205,8.998374,172.475605,0
192.168.100.2,60369,65.55.223.13,80,3,194,3,194,0,0,876.539098,9.000537,172.4341559,0
192.168.100.2,60370,64.4.23.174,80,3,194,3,194,0,0,877.579042,8.999547,172.4531246,0
192.168.100.2,60371,157.55.56.173,80,3,194,3,194,0,0,877.579045,8.999548,172.4531054,0
192.168.100.2,60372,157.56.52.35,80,3,194,3,194,0,0,877.579046,8.999548,172.4531054,0
192.168.100.2,60373,111.221.77.170,80,3,194,3,194,0,0,877.580154,8.998441,172.4743208,0
192.168.100.2,60374,91.190.218.52,443,3,194,3,194,0,0,877.750186,8.999809,172.4481042,0
192.168.100.2,60375,91.190.218.52,80,3,194,3,194,0,0,879.360044,8.99951,172.4538336,0
192.168.100.2,60377,65.55.223.17,443,3,194,3,194,0,0,886.119864,9.00066,172.4317994,0
192.168.100.2,60378,65.55.223.17,80,3,194,3,194,0,0,887.730104,9.000373,172.4372979,0
192.168.100.2,60381,157.56.52.41,443,2,132,2,132,0,0,898.261471,2.970304,355.5191657,0
192.168.100.2,60383,157.55.130.155,443,2,132,2,132,0,0,899.291877,2.970637,355.479313,0
192.168.100.2,60387,157.56.52.41,80,2,132,2,132,0,0,899.851871,3.000662,351.9223425,0
192.168.100.2,60388,111.221.77.162,443,1,66,1,66,0,0,900.302073,0,0,0
192.168.100.2,60389,157.55.130.155,80,1,66,1,66,0,0,900.881977,0,0,0
192.168.100.2,60390,157.55.235.153,443,1,66,1,66,0,0,901.342021,0,0,0
192.168.100.2,60391,157.55.56.161,443,1,66,1,66,0,0,901.342023,0,0,0
192.168.100.2,60392,157.55.130.146,443,1,66,1,66,0,0,901.342025,0,0,0
192.168.100.2,60393,111.221.77.162,80,1,66,1,66,0,0,901.913229,0,0,0
